새벽	TI
대표팀	OG
건국대	OG
김진용	PS
이동국	PS
백지훈	PS
천재골잡이	PS
박주영	PS
서울	LC,OG
K리그	OG
49일	DT
이건희	PS
민주노동당	OG
곽정숙	PS
보건복지가족부	OG
2009년	DT
여름방학동안	DT
경남	LC,OG
올해	DT
겨울방학	DT
2010-02-23	DT
20:47:55	TI,DT
MS	OG
맨유	OG
호날두	PS
밸류플러스	OG
육심길	PS
롯데	OG
기린	OG
해태음료안성공장	OG
미국	LC
피플지	OG
2009	DT
제시카론디스	PS
JessicaLowndes	PS
리케리	PS
LikkeLi	PS
에이미스마트	PS
AmySmart	PS
첼시온더록스	OG
캘빈클라인	OG
비쥬필립스	PS
BijouPhillips	PS
잭휴스턴	PS
JackHuston	PS
스콧칸	PS
ScottCaan	PS
뿌까	PS
검찰	OG
아프리카	LC
나이지리아	LC
카메룬	LC
1996년	DT
2000년	DT
09년10월24일	DT
바이커스탈렛	OG
Bikerstarlet	OG
일본	LC
공정거래위원회	OG
거제도	LC
재정부	OG
대우인터내셔널	OG
포스코	OG
POSCO	OG
6일	DT
올해	DT
이마트	OG
롯데마트	OG
홈플러스	OG
마트	OG
김	PS
금감원	OG
대우조선해양	OG
만도	OG
현대산업개발	OG
1·4분기	DT
12일	DT
삼성전자	OG
독일	LC
2주	DT
토요	DT
당일	DT
낙동정맥	LC
나가노	LC
가을	DT
낙동강	LC
1999년	DT
10년	DT
KB투자증권	OG
전남	LC,OG
2004	DT
서민금융기관	OG
KBL	OG
최윤아	PS
21초	TI
문광부	OG
2008년12월	DT
배삼룡	PS
서울	LC,OG
풍납동	LC
아산병원	OG
27일	DT
오전	TI
롯데	OG
플라마	OG
교육과학기술부	OG
교육개혁현장착근지원협의회	OG
어누라다코이랄라	PS
다	PS,DT,OG
국토해양부	OG
금일	DT
국무회의	OG
오는17일부터	DT
11일	DT
그림자	PS
송지원	PS
2008년1월19일	DT
국가대표팀	OG
솔로몬저축은행	OG
한국신용평가	OG
28일	DT
정동영	PS
2월	PS,DT
임시국회	OG
6월	DT
잉글랜드	LC
데이비드베컴	PS
LA갤럭시	OG
할리우드이	LC
톰크루즈	PS
박세리	PS
다음주	DT
미국	LC
줄리엣루이스	PS
김남길	PS
임창용	PS
도미노피자	OG
에버랜드	LC
대전	LC,OG
V리그	OG
디앤디컴	OG
노영욱	PS
인텔	OG
3월22일부터	DT
14일	DT
박지성	PS
알렉스퍼거슨	PS
케이사인	OG
최승락	PS
3년	DT
23일	DT
ASUStek사	OG
에스티컴퓨터	OG
서희문	PS
전세환	PS
여민지	PS
샤이니	PS
SM엔터테인먼트	PS,OG
씨엔블루	PS
할리우드	LC
리츠칼튼호텔	OG
9일	DT
모로코	LC
멕시코	LC
카이로	LC
시카고	LC
2016년	DT
강소라	PS
무의도	LC
도요타자동차	OG
창원대	OG
부산대	OG
차황면	LC
지난해	DT
황매산	LC
SK	OG
최정은	PS
인천	LC,OG
인천지역	LC
인천시	LC
인천광역시	LC
의료관광재단	OG
김봉기	PS
한국관광공사	OG
19일	DT
9	DT
월9일~9월11일	DT
안동	LC
손민한	PS
전경윤	PS
한국	LC,OG
하은주	PS
김계령	PS
원주동부	OG
지나ㄴ5일	DT
원주	LC,OG
2007∼2008	DT
일본	LC
E1	OG
북한	LC
정상회담	OG
맨체스터	OG
두산	OG
홍성흔	PS
용덕한	PS
박한이	PS
2001년	DT
화성시	LC
수원세무서	OG
태백상공회의소	OG
설	DT
인왕산	LC
면목동	LC
잠실	LC
강화도	LC
건설은행	OG
중국은행	OG
BOC	OG
중국농업은행	OG
2005년	DT
싱가포르	LC
7월첫째주	DT
3주	DT
넷째주	DT
양양군소나무	LC
금강소나무숲	LC
오는5월	DT
축구공화국	OG
나무자전거	PS
충주	LC
교현초등학교	OG
청남초등	OG
학교	OG
여성가족부	OG
백희영	PS
4월부터10월까지	DT
지축	LC
수서	LC
송파	LC
강남	LC
작년12월말	DT
서태지	PS
11개월	DT
조진웅	PS
이	PS,OG
오늘	DT
지난해10월	DT
유럽	LC
한-EUFTA	OG
황재균	PS
매일	DT
한국야구위원회	OG
KBO	OG
LG생활건강	OG
지난해10월29일	DT
해태음료	OG
아사히맥주	OG
보스턴	OG
피어스	PS
전반	TI
오후2시	TI
2군단사령부	OG
산림청	OG
육군본부	OG
강원도	LC
경찰	OG
송	PS
LG	OG
제이미브라운	PS
KIA	OG
제주시	LC
삼도1동	LC
떡가게	OG
김동필	PS
가르시아	PS
뉴올리언스	OG
12분	TI
샌안토니오	OG
메이저리그	OG
제리로이스터	PS
마해영	PS
양준혁	PS
신경식	PS
용인경찰서	OG
김정훈	PS
4일	DT
오전10시	TI
지구대	OG
2010년도	DT
치안종합성과평가향상방안보고회	OG
토착비리척결과관련하ㄴ점검회의	OG
우	PS
엄기준	PS
오는5일	DT
성남	OG
2008	DT
현대캐피탈배구단배구	OG
1일	DT
신승훈	PS
5일	DT
영락공원	LC
실로암공원	LC
백운	LC
대정	LC
추모공원	LC
양산	LC
김해	LC
안데르센쥬피터	OG
디자인스킨	OG
2010-02-23	DT
20:47:55	TI
태백역	LC
시외버스터미널	LC
태백시	LC
황연동	LC
지나ㄴ1998년	DT
황지2동	LC
연화동	LC
오는	DT
26일	DT
댈러스	OG
민주노동당	OG
진보신당	OG
안병만	PS
이주호	PS
내년6월까지	DT
작년	DT
부산	LC,OG
10여년전	DT
오전9시	TI
창원종합사격장	OG
기독교	OG
베트맨	OG
핀란드	LC
7억팔	PS
김진우	PS
기아	PS,OG
귀네슈	PS
이승엽	PS
니혼햄	OG
유팔무	PS
민노당	OG
정부	OG
수원	OG
경은저축은행	OG
오후	TI
명지대	OG
강을준	PS
진야곱	PS
신탄리	LC
아스널FC	OG
다음주월요일	DT
자정	TI
아시아	LC
아시아경제	LC
투애이니원	PS
2NE1	PS
씨엘	PS
로드리게즈	PS
5주	DT
지나ㄴ일	DT
삼송지구	LC
7년	DT
최경주	PS
2009.4.1~2009.7.30	DT
우체국	OG
9시	TI
제주	LC
가파도	LC
한나라당	OG
친이계	OG
내일로	OG
16일	DT
수유동	LC
호텔아카데미하우스	OG
세종시	LC
오채아	PS
민주당	OG
삼성	OG
테렌스레더와	PS
강혁	PS
빅터	PS
토마스	PS
권태신	PS
산부인과병원	OG
0.3초	TI
일레인스튜어트	PS
지나ㄴ27일	DT
베버리힐즈	LC
김택민	PS
고려대	OG
사분위	OG
1월1일자	DT
대표팀	OG
문태호	PS
11/01	DT
22:54	TI
표트르	PS
인류학민족지학박물관	OG
대관령	LC
피닉스	OG
올시즌	DT
프리드리히스하펜	OG
김병현	PS
데이비드코티스	PS
코티스	PS
바비셰이	PS
히딩크	PS
호나우두	PS
1992년	DT
EPL	OG
시즌	DT
에인트호벤	OG
고대올스타	OG
한국농구연맹	OG
강남성형외과	OG
이희영	PS
양현진	PS
조동인	PS
유소연	PS
신지애	PS
키자니아	LC
대한항공현대기아자동차	OG
롯데제과	OG
LG하우시스	OG
미스터피자	OG
KCC	OG
하승진	PS
2009년3월15일	DT
일요일	DT
오전8시45분	TI
소니	OG
속초시	LC
WHO	OG
세계보건기구	OG
3주년	DT
2011	DT
속초	LC
오후3시	TI
시청	OG
NHK위성채널	OG
지나ㄴ21일	DT
최	PS
한	LC
미	LC
이명박	PS
무삼파	PS
시크	PS
박진희	PS
러블리	PS
엄지원	PS
화려	PS
왕빛나	PS
제주물류연구회	OG
29일	DT
블룸버그통신	OG
루살	OG
올해2분기	DT
22일	DT
울산	LC,OG
19시	DT,TI
부천	OG
대구	LC,OG
전북	OG
19시30분	TI
SBSSPORTS	OG
22시	DT
포항	OG
PSB부산방송	OG
광주	LC,OG
18시	TI
현대캐피탈	OG
후인정	PS
방송통신위원회	OG
2일	DT
롯데백화점창원점	OG
오는11월16일	DT
염혜선	PS
목포여상	OG
한유미	PS
현대건설	OG
한송이	PS
도로공사	OG
2010-02-25	DT
19:32:50	TI
바리바스	OG
바칸	OG
이대	OG
홍대	OG
쭌	PS
현대	OG
새벽	TI
겨울	DT
대우조선	OG
그리스	LC
현대중	OG
후반10분	TI
마빈루소	PS
백두	LC
11/14-15	DT
매월2,4주	DT
,	DT
여섯주	DT
5.1~3	DT
㈜녹십자홀딩스	OG
18일	DT
오전11시	TI
경기도	LC
용인	LC
(사)한국도시철도협회	OG
의왕시	LC
한국철도대학철도철도	OG
2011년	DT
컴투스	OG
구글	OG
21년전	DT
송일국	PS
한채영	PS
한고은	PS
김민종	PS
MBC	OG
주말	DT
다음달6일	DT
춘천	LC
2010정월대보름	DT
오후1시	TI
삼천동	LC
의암공원	LC
달	LC
능내초	OG
마전중	OG
완전초	OG
검단고	OG
김진표	PS
이종걸	PS
기아자동차	OG
소비자시민모임	OG
21일	DT
강성범	PS
ESPN	OG
배유나	PS
양효진	PS
소렌스탐	PS
로레나오초아	PS
횡성군자원봉사센터	OG
지나ㄴ2007년1월	DT
군	OG
자원봉사	OG
전주이씨대동종약원	OG
이구	PS
李玖	PS
이환의	PS
의친	PS
이강	PS
李堈	PS
1877-1955년	DT
이원	PS
李源	PS
현대홈쇼핑	OG
박찬호	PS
30일	DT
서귀포시	LC
총무과	OG
스탠더드앤푸어스	OG
S&P	OG
지나ㄴ1월	DT
8년9개월	DT
이경희	PS
금왕읍	LC
채홍조	PS
원남면	LC
박찬근	PS
소이면	LC
케이앤엔터테인먼트	OG
케이앤컴퍼니	OG
김용빈	PS
삼성화재	OG
15일	DT
LG트윈스	OG
KIA타이거즈	OG
김민지	PS
장문영	PS
유재석	PS
아틀레티코마드리드	OG
프리미어리그	OG
첼시	OG
세르비아	LC
몬테네그로	LC
마테야케즈만	PS
로드리게스	PS
안정환	PS
마드리드	OG
지나ㄴ17일	DT
속초고	OG
지난달30일	DT
남성고	OG
제너럴모터스	OG
GM	OG
김송희	PS
타나메라CC	LC
뉴로테크	OG
다음달10일	DT
서울시	LC
강남구	LC
도곡동	LC
맨체스터유나이티드	OG
신형엔진	PS
보령권	LC
9월29일	DT
서해	LC
경남	LC
문성현	PS
금속노조연맹	OG
창원	LC
마산	LC
진해	LC
두시간	TI
소녀시대	PS
이탈리아	LC
외교부	OG
위성락	PS
조현동	PS
2009년	DT
엠씨더맥스	PS
조용필	PS
서울삼성	OG
이상민	PS
1년간	DT
SK텔레콤	OG
블랙베리	OG
천호	LC
한강시민공원	LC
우리	OG
동부	OG
강대협	PS
김나우	PS
라켓볼협회	OG
전훈	PS
문성민	PS
빌리진킹	PS
여성스포츠재단	OG
1993년부터올해	DT
김형범	PS
조재진	PS
SBS	OG
30년동안	DT
박철우	PS
이찬성	PS
파트론	OG
부광약품	OG
서상민	PS
까보레	PS
웰링턴실바	PS
제주윈드오케스트라	OG
대한생명	OG
이라크	LC
지나ㄴ5월	DT
NOC	OG
IOC	OG
김호	PS
김동주	PS
최준석	PS
다비	PS
비쥬	PS
2003년	DT
1942년	DT
지미헨드릭스	PS
1970년	DT
서울SK	OG
상무	OG
이상준	PS
올해부터2014년까지	DT
대한축구협회	OG
조중연	PS
다음달3일	DT
코트디부아르	OG
17일	DT
건설교통부	OG
프랑스	LC
푸조시트로엥	OG
PSA	OG
브라질	LC
2008~2009년	DT
검찰	OG
박태환	PS
오후6시30분	TI
박	PS
지나ㄴ2005년	DT
열린우리당	OG
주니치	OG
한신	OG
영신금속공업	OG
내달22일	DT
25일	DT
KT＆G	OG
에밀리배스텔	PS
로리케인	PS
캐나다	LC
손학규	PS
1년반	DT
울산시	LC
지나ㄴ1월부터	DT
0910시즌	DT
최강희	PS
안젤코	PS
신	PS
오초아	PS
왈론드	PS
해리거	PS
만자니오	PS
10:10~10:20	TI
여의도	LC
7일	DT
한화2군	OG
장종훈	PS
오는16일	DT
볼보트럭코리아	OG
7월1일부	DT
김영재	PS
정양	PS
김호철	PS
장애인직업재활시설협회	OG
오는20일	DT
이미연	PS
고용노동부	OG
2011년도	DT
김연아	PS
지나ㄴ24일	DT
스포츠토토	OG
우사인볼트	PS
보루네오가구	OG
정성균	PS
9월	DT
베트남	LC
메가스타	OG
국회	OG
태연	PS
플로리다주	LC
마이애미	LC
래리	PS
조지	PS
노스캐롤라이나대	OG
NBA	OG
그	OG
지난주	DT
1분	TI
아르노드투어넌트	PS
오후4시30분	TI
카프카	PS
부개문화사랑방	OG
부평아트센터	OG
넬슨신	PS
안선주	PS
홍진주	PS
그레코로만형	PS
김인섭	PS
김정섭	PS
클린턴	PS
중동	LC
하루	DT
신치용	PS
김주성	PS
흥국생명	OG
이성희	PS
경찰청	OG
남현희	PS
이날	DT
임호	PS
오는12월	DT
2012년1월	DT
20	DT
노원신문	OG
미드필드	LC
토튼햄	OG
전반17분	TI
하메드미도	PS
페널티아크	LC
아	LC
11	TI
공	PS
부마항쟁	OG
518	DT
에이데이타코리아	OG
ADATATechnologyKorea	OG
박은준	PS
한강	LC
2006년4월	DT
박인비	PS
그린	LC
5시간전후	TI
데이비드벤틀리	PS
모르텐페데르센	PS
한국대표팀	OG
여상	PS
2년	DT
석진욱	PS
하와이	LC
6개월	DT
김창호	PS
양양지사	OG
볼트	PS
2008년	DT
뉴욕	LC
1월	DT
구청건축과	OG
효성	OG
재판부	OG
김창수	PS
아이스네트워크	OG
최희섭	PS
포드	OG
크라이슬러	OG
도요타	OG
20일	DT
잠실주공5단지	LC
제일모직	OG
락휴	OG
이상훈	PS
성결대학교예술대학	OG
국립합창단	OG
수잔페테르센	PS
차붐	PS
차범근	PS
1991년	DT
9시즌	DT
레이커스	OG
덴버너게츠	OG
제피로스골프클럽	OG
지나ㄴ해	DT
제주도	LC
정가은	PS
한달	DT
유승호	PS
백민철	PS
한화	OG
제이씨엔터테인먼트	OG
정재은	PS
하나은행	OG
2006년	DT
한기주	PS
한국존슨앤드존슨비젼케어	OG
아일랜드	LC
24일	DT
스텐포드대	OG
이스라엘	LC
와이즈만연구소,	OG
중국	LC
칭화대	OG
생활협동조합	OG
제라르울리	PS
올림피크리옹	OG
레이몽도메네크	PS
강병현	PS
박정아	PS
천재골잡이	PS
박주영	PS
FC서울	OG
고성군선발팀	OG
마지막날	DT
유연경	PS
정정옥	PS
횡성군선발팀	OG
BMW	OG
영국	LC
아스널	OG
백주년기념교회	OG
이재철	PS
새대로교회	OG
양승헌	PS
예능교회	OG
조건회	PS
북경온누리교회	OG
강부호	PS
아름답ㄴ교회	OG
인치승	PS
기독교대한감리회	OG
남연회	PS
임영훈	PS
컴패션	OG
박지은	PS
이정은	PS
김영주골프	OG
시애틀	OG
14년이	DT
분	PS
지나ㄴ2001년	DT
제이슨지암비	PS
오클랜드애슬레틱스	OG
스즈키이치로	PS
더클래식500	OG
아침	TI
저녁	DT,TI
수원시청	OG
호남대	OG
문용관	PS
노성운	PS
버그테스트	OG
지나ㄴ10년간	DT
솔루션링크	OG
동해	LC
여름	DT
80년대	DT
무디스	OG
지나ㄴ2002년	DT
어제	DT
정훈	PS
혜숙	PS
K리그	OG
10일	DT
3∼4일	DT
베어스데이	DT
가임기간	DT
인터라인	OG
초도짱	PS
4시까지	TI
북신동사무소	OG
유정복	PS
코비브라이언트	PS
LA레이커스	OG
르브론제임스	PS
클리블랜드캐벌리어스	OG
베이징	LC
에이머리	PS
2002년	DT
2	DT
설동근	PS
장제원	PS
장호	PS
강타	PS
장용	PS
정한용	PS
파머	PS
윌리엄스	PS
김재박	PS
김성한	PS
한신정평가	OG
벽산건설	OG
김인경	PS
지은희	PS
수잔	PS
JAMA	OG
자전거탄풍경	PS
이시영	PS
앙드레김	PS
이인섭	PS
김태호	PS
토스카나	LC
피렌체	LC
시에나	LC
키안티	LC
루카	LC
Lucca	LC
메츠	OG
다저스	OG
켄트	PS
지나ㄴ9일	DT
행정안전부	OG
국무회	OG
10월10,17일	DT
오서산	LC
성현리	LC
성골주차장	LC
광천젓갈시장	LC
서해바다	LC
세네갈	LC
토고	OG
강릉시	LC
미치마이어	PS
이카루스	OG
2008년2월	DT
폴란드	LC
터키	LC
러시아	LC
7월	DT
지나ㄴ2일	DT
AS로마	OG
2007-08	DT
유럽축구연맹	OG
UEFA	OG
을지대학교	OG
을지병원	OG
2시	DT,TI
경기	LC
벽제승화원	OG
고양	LC
정세균	PS
서울우유	OG
남서울골프장	OG
라이브의황제	PS
이승철	PS
20년	DT
남원농협	OG
대의원	OG
정기대의원회	OG
서재응	PS
마가리토	PS
WBA	OG
지난해12월	DT
이달	DT
신흥학원	OG
대구독립영화협회	OG
오는21일	DT
2005	DT
후반16분	TI
진숙희	PS
후반30분	TI
김주희	PS
윤보선	PS
1949~	DT
1950년	DT
제2공화국	LC
노	PS
시흥	LC
중앙정부	OG
군자지구	LC
노용수	PS
White	OG
Limon	OG
박경완	PS
2004시즌	DT
김희선	PS
일원	PS
클레멘트	PS
성남시	LC
전남도	LC
용인시	LC
광주시	LC
최정	PS
루이	PS
남양유업	OG
매일유업	OG
연세우유	OG
비락	OG
부산우유	OG
건국우유	OG
파스퇴르	OG
낙농진흥회	OG
농식품부	OG
써니	PS
효연	PS
성남전K-리그	OG
전	TI,OG
동해시	LC
포터필드	PS
지나ㄴ시즌	DT
애플	OG
롯데칠성음료	OG
경동나비엔	OG
현대모비스	OG
공정위	OG
지나ㄴ2001년부터	DT
푸조	OG
BMW자동차	OG
폭스파겐	OG
계	PS
밤	TI
스코틀랜드	LC
컴버놀드	LC
클라이드	OG
스코틀랜드2부리그	LC
전반45분	TI
정규시즌	DT
21년	DT
임동규	PS
선동열	PS
세계전자정부	OG
파놈이룸	PS
토니자	PS
태국	LC
30주년	DT
하이닉스반도체	OG
올해2·4분기	DT
마이크론	OG
청와대	OG
이집트	LC
브레댄코	OG
3	DT
3일	DT
김광현	PS
김현수	PS
지나ㄴ8월	DT
예년	DT
테렌스레더	PS
환경부	OG
버튼	OG
06~07	DT
한국남자유도대표팀	OG
KBS제주방송총국	OG
장성환	PS
오전11시10분	TI
KBS	OG
루키	PS
보건환경연구원	OG
대한적십자혈액원	OG
중부권	LC
대전시	LC
충남	LC
5월	DT
24시간	TI
Lib-tech	OG
oneballjoy	OG
터프가이	PS
김남일	PS
성형외과전문의단체의	OG
성형코리아	OG
식약청	OG
쿠바	LC
남	LC
북	LC
알리바바닷컴	OG
야후	OG
이석채	PS
KT	OG
김은혜	PS
맨유	OG
진주MBC	OG
김영철	PS
개리레스	PS
개	PS
유타	LC,OG
선댄스	LC
재범	PS
매주월수금	DT
매주월,수,금	DT
인천연안여객터미널	LC
이스타항공	OG
매주일,수,토	DT
세관	OG
윤증현	PS
G20	OG
지난달	DT
키우ㅁ증권	OG
스캇	PS
벙커	LC
김영광	PS
전반15분	TI
마철준	PS
김용대	PS
이상호	PS
이진호	PS
전병두	PS
구하라	PS
노주현	PS
군포수리고	OG
워싱턴주	LC
에버렛	LC
2008~2009시즌	DT
국제빙상경기연맹	OG
ISU	OG
임예진	PS
루원시티	LC
지난시즌까지	DT
김지석	PS
손예진	PS
이민호	PS
스포츠서울닷컴	OG
감바오사카	OG
재키	PS
코스닥	OG
지나ㄴ1월25일자	DT
9년	DT
피자	OG
파파존스피자	OG
6자회담	OG
한델스블라트	OG
스탠더드앤드푸어스	OG
유로존	LC
지나ㄴ4월	DT
한해	DT
2년이상	DT
법원	OG
5년이상	DT
영진위	OG
정지호	PS
이준기	PS
1월말	DT
멘토엔터테인먼트	OG
매니지먼트사	OG
제이지컴퍼니	OG
포드자동차	OG
지나ㄴ82년	DT
지난해까지	DT
지나ㄴ85년	DT
김시진	PS
동군	OG
94년	DT
정명원	PS
서군	OG
태평양	OG
자유선진당	OG
이회창	PS
J리그	OG
가시와레이솔	OG
리틀마라도나	PS
최성국	PS
울산현대	OG
조전혁	PS
친이	OG
친박	OG
친노	OG
무현	PS
시민영상문화기구	OG
문예창작과	OG
장원재	PS
캘리포니아주	LC
란초미라지	LC
미션힐스골프장	OG
KBSN	OG
기성용	PS
셀틱	OG
라일리	PS
스폴스트라	OG
하프타임FC서울서포터즈수호신	TI
서울아빠	OG
하	TI
아빠	OG
서대문구	LC
홍제동	LC
하‘	TI
송죽원FC서울	OG
발렌타인데이	DT
윤종신꽃배달	OG
교도통신	OG
이강래	PS
김원길	PS
WKBL	OG
유소녀	PS
배성호	PS
선	PS
페더러	PS
2000년	DT
시드니	LC
페네르바체	OG
지코	PS
전반전	TI
후반	TI
고성골드낚시	OG
이종기	PS
이치로	PS
평창군	LC
도암면	LC
용평리조트	OG
김상현	PS
도교육청	OG
오는12일까지	DT
오후7시	TI
일산	LC
보아	PS
김건모	PS
버즈	PS
윤도현	PS
쥬얼리	PS
장윤정	PS
MC몽	PS
구하이벤	PS
아타	PS
여베이	PS
런던	LC
PD연합회	OG
영화제작가협회	OG
현대차	OG
이란	LC
조세무리뉴	PS
이동국	PS
부산아이파크	OG
임종석	PS
CJ제일제당	OG
녹십자	OG
유한양행	OG
나이키골프	OG
50~70년대	DT
펠레	PS
카운트다운	OG
내셔널리그	OG
중부지구	OG
아메리칸리그	OG
서부지구	OG
애리조나	OG
LA에인절스	OG
콜로라도	OG
1997년	DT
프레드커플스	PS
지나ㄴ3월2일	DT
풀럼	OG
듀크대마이크크르지쥬스키	PS
지나ㄴ주	DT
마린실리치	PS
크로아티아	LC
요미우리	OG
이듬해	DT
우에다	PS
4년	DT
삼계탕	OG
신촌삼계탕	OG
5년이내	DT
29분	TI
마이클캐릭	PS
미들즈브러	OG
루니	PS
4주차	DT
지나ㄴ4월6일	DT
3개월	DT
내달6일	DT
황	PS
차	PS
서울서울하우젠	LC
송유걸	PS
내1	OG
김승수	PS
배우학교	OG
한별	OG
의대	OG
예방의학교실	OG
최재욱	PS
신제록	PS
마퀸챈들러	PS
박기남	PS
한규식	PS
초승달	LC
보름달	LC
로코미디에이트	PS
US오픈챔프	OG
제프오길비	PS
호주	LC
D.J.트라한	PS
기상청	OG
남해상	LC
중부지방	LC
오는9월1일부	DT
앤드류	PS
하우스	PS
소니컴퓨터엔터테인먼트	OG
SCE	OG
E!TV	OG
지난해부터	DT
카메니	PS
괌	LC
단동병원	OG
집안진료소	OG
장백진료소	OG
압록강	LC
두만강	LC
퍼디낸드	PS
테라움	OG
8월12일	DT
안양시	LC
서정테크	OG
강	PS
유엔	OG
마이데일리	OG
해태	OG
김상진	PS
카린	PS
스웨덴	LC
레저신문	OG
이종현	PS
한양	LC,OG
원주시	LC
대경대학	OG
강삼재	PS
실용음악과	OG
소찬휘	PS
문화예술위원회	OG
올해상반기	DT
매주월,목요일	DT
오후3시부터4시까지	TI
어린이날	DT
고양시	LC
퍼시픽리그	OG
시애틀매리너스	OG
호텔롯데	OG
에이케이	OG
AK이	OG
호텔신라	OG
지나	DT
브룸바	PS
지	DT
올림픽팀	OG
8월8일	DT
한달전	DT
6월2일부터14일까지	DT
2주간	DT
양양	PS
변병주	PS
4월	DT
고르바초프	PS
소련공산당	OG
KGB	OG
지도부	OG
보수파	OG
지나ㄴ1991년8월19일	DT
흑해	LC
크림반도	LC
사흘	DT
대유에이텍	OG
5월31일	DT
대유기술연구소	OG
장진영	PS
김영균	PS
지나ㄴ1월초	DT
이번주	DT
전하교차로	LC
호계로사거리	LC
김해지역	LC
안민터널	LC
진해지역	LC
심상정	PS
병훈	PS
루비	PS
김동수	PS
여오현	PS
알	PS
호포드	PS
폴피어스	PS
케빈가넷	PS
불암산	LC
회룡역	LC
5시간30분	TI
5시	TI
1시간30분	TI
6시30분	TI
그레이싱어	PS
휘트니휴스턴	PS
2월6일	DT
올림픽공원	LC
오는10일	DT
정대영	PS
김연경	PS
황연주	PS
최광희	PS
한국선수단	OG
삼성라이온즈	OG
본즈	PS
내년시즌	DT
웬델화이트	PS
본프레레호황태자	PS
연세대원주캠퍼스	OG
나혜원	PS
김형성	PS
한길안과병원	OG
김장훈	PS
2007년	DT
동방신기	PS
김동률	PS
SG워너비	PS
비	PS
브라운아이즈	PS
신화	PS
IDG	OG
오는11월2일	DT
횡성군	LC
황찬희	PS
주영훈	PS
김종국	PS
이현도	PS
강동구	LC
강북구	LC
강서구	LC
도봉구	LC
동작구	LC
마포구	LC
성북구	LC
송파구	LC
양천구	LC
용산구	LC
사법제도개혁특위	OG
법원소위	OG
여상규	PS
사법부	OG
제도	OG
최지우	PS
시세이도	OG
코리아	LC
7월둘째주말	DT
남원	LC
5시간	TI
원	LC
9월27일	DT
민둥산	LC
증산초등학교	OG
화암약수	LC
정선	LC
25,	DT
10월2,	DT
귀떼기청봉	LC
지나ㄴ10일	DT
후반기	DT
지나ㄴ99년이후	DT
정민태	PS
6년	DT
2년전	DT
2PM	PS
유호철	PS
올해부터	DT
정	PS
노무현	PS
자크로게	PS
2012년	DT
그룹이	OG
미쓰비시도쿄파이낸셜그룹	OG
홍명보장학재단	OG
아프리카	LC
맥스무비	OG
11년	DT
KT&G	OG
전년	DT
5년전	DT
1년	DT
50년	DT
100년	DT
21세기이	DT
전날까지	DT
이병헌	PS
내년	DT
제3주	DT
4월12일~13일	DT
북한산	LC
연습바위	LC
우이동	LC
김규동	PS
오후2시50분	TI
국립환경과학원	OG
유인촌	PS
스코비	PS
LPGA	OG
SK와이번스	OG
지나ㄴ25일	DT
호세카브레라	PS
도미니카공화국	LC
넬슨	PS
크루즈	PS
천안	LC
계양산공원	LC
한강청	OG
롯데건설	OG
계양산	LC
SK네트웍스	OG
2분기	DT
브라이언트	PS
전병호	PS
정상호	PS
로스앤젤레스	LC
타임스	OG
시의회	OG
대한민국	LC
윤상윤	PS
이배영	PS
김동환	PS
동서화랑	OG
오는28일까지	DT
스포츠	OG
06/	DT
07	DT
OPTIONCODELTD	OG
LG전자	OG
김쌍수	PS
90초	TI
매년	DT
임충희	PS
GS건설	OG
박상우	PS
벤시드란	PS
BenSidran	PS
심수창	PS
바레인	LC
지나ㄴ8일	DT
위덕대학교	OG
이세은	PS
딜론테웨스트	PS
조스미스	PS
제임스	PS
이원수	PS
이정석	PS
박훈근	PS
1쿼터중반	TI
이규섭	PS
하나금융지주	OG
탄천	LC
박재범은오는4월	PS
셋째주	DT
10:50~11:10	TI
압구정지구	LC
류현진	PS
황선홍	PS
하성래	PS
인하대	OG
황동일	PS
경기대	OG
오ㄹ시즌	DT
현대그룹	OG
현대자동차그룹	OG
CSX	OG
치포틀레	OG
스트라이커	OG
VMWare	OG
화요일	DT
MBC라디오	OG
김정수	PS
네덜란드	LC
스위스	LC
대만	LC
허비	PS
오	DT
전반3분	TI
정조국	PS
전반11분	TI
데얀	PS
게이트웨이	OG
순천	LC
용문천지역	LC
07/08	DT
리버풀	OG
13일	DT
2007~2008	DT
이장수	PS
궈안	LC
F조	OG
가시마앤틀러스	OG
의회	OG
이틀째	DT
장광균	PS
2007~	DT
이은상	PS
김필진	PS
문영진	PS
대법원	OG
성유리	PS
이진	PS
2월28일일요일	DT
저녁5시20분	TI
한국콘텐츠아카데미	OG
방송콘텐츠엘리트스쿨	OG
게임아카데미	OG
문화콘텐츠기획창작아카데미	OG
콘텐츠	OG
문화체육관광부	OG
한국콘텐츠진흥원	OG
재무부	OG
혁명수비대	OG
로이터	OG
송승준	PS
오ㄹ3월26일	DT
파드	PS
한라I&C	OG
와이드	OG
성남일화	OG
조현재	PS
남창섭	PS
S&T중공업	OG
최종	PS
3월	DT
4월부터11월까지	DT
매월첫째셋째주목요일	DT
둘째주토요일	DT
넷째주일요일	DT
최복숙	PS
강서구의회	OG
30년전	DT
명승희	PS
롯데자이언츠	OG
카림가르시아	PS
이종욱	PS
이대형	PS
일로나코르스틴	PS
진해시	LC
불모산	LC
LA클리퍼스	OG
2008.12.30일자	DT
더타임스	OG
남윤형	PS
통영	LC
지나ㄴ97-98시즌	DT
샬럿	OG
김영녀	PS
강원도청	OG
7월22일	DT
8월18일	DT
디즈니	OG
지나ㄴ3월17일부터4월20일	DT
2해	DT
지식경제부	OG
내년부터	DT
5월말부터	DT
한달간	DT
올림픽대표팀	OG
프로축구연맹	OG
정월대보름	DT
대한배구협회	OG
신현택	PS
한정호	PS
전경업	PS
원당초	OG
봄내초	OG
김문화	PS
청주	LC
청원	LC
오후5시30분	TI
1시간	DT
뉴욕타임스	OG
NYT	OG
월스트리트저널	OG
WSJ	OG
가트너	OG
올해2.4분기	DT
노키아	OG
서울중앙지법	OG
김용준	PS
금보라	PS
오현경	PS
원주문학카페	OG
KDB산업은행	OG
민유성	PS
RBS우즈베키스탄은행	OG
유니텍전자	OG
정대현	PS
토티	PS
이미숙	PS
진실	OG
최순영	PS
지나ㄴ19일	DT
진실화해위원회	OG
1979년	DT
YH노조	OG
김경숙	PS
하회마을	LC
IMAGINE	OG
강남점	OG
(주)만나어	OG
(주)화인코리아	OG
(주)인아정밀	OG
미르치과	OG
어부지리	PS
조동건	PS
대학	OG
김춘진	PS
김성환	PS
타임머신	OG
최주영	PS
본프레레	PS
신승현	PS
빙그레	OG
배창순	PS
2시10분	DT
인천시청소년회관	OG
강원도당	OG
내일	DT
오는22일	DT
첫날	DT
중앙선거관리위원회	OG
제니트	OG
딕아드보카트	PS
김동진	PS
페르난도리크센	PS
빅토르파이줄린	PS
포스코	OG
현대중공업	OG
기아차	OG
LG화학	OG
신한지주	OG
KB금융	OG
세종시청문회	OG
우정사업본부	OG
정기국회	OG
K2리그	OG
로이스터	PS
정민철	PS
우리히어로즈	OG
한국산핵잠수함	PS
콜로라도로키스	PS
웨스트	PS
1998년부터	DT
FTA	OG
한국수상레저안전연합회	OG
권혁대	PS
이베이	OG
G마켓	OG
이준영	PS
동안구	LC
비산동	LC
조선왕조	DT
태조	PS
조선	DT,OG
대교	OG
부산교통공사	OG
안준태	PS
부산진구	LC
범천동	LC
2010년	DT
이현경	PS
국제통화기금	OG
IMF	OG
아주	OG
전날	DT
김하늘	PS
하이마트	OG
러브필름닷컴	OG
1988년	DT
자메이카	LC
비비안웨스트우드by다리인터내셔날	OG
상반기	DT
하반기	DT
눈높이	OG
콘	PS
드래곤	PS
아이알윈드파워	OG
2006년11월27일(월)부터2006년12월17일(일)까지	DT
EXR	OG
한주	DT
5월4일~5월9일	DT
친	OG
국민은행	OG
이익수	PS
5월13일	DT
목요일	DT
정영두	PS
15년	DT
박현승	PS
이대호	PS
연세대	OG
교육과학대학	OG
국토해양위	OG
기재위	OG
인디고필름	DT
키다리필름	OG
황금나비	OG
미니필름	OG
고	OG
밀양시	LC
유비벨록스	OG
기업은행	OG
한국마사회	OG
이병규	PS
지난해초자살예방	DT
노인자살예방센터	OG
박명환	PS
지나ㄴ6월2일	DT
블랭크	PS
1시간58분	TI
국립수의과학검역원	OG
MS	OG
패서디나	OG
고우석	PS
김재구	PS
정대세	PS
가와사키프론탈레	OG
윤성만	PS
다니엘켈만	PS
연방정부	OG
4월부터	DT
한국주택금융공사	OG
우즈	PS
퍼스텍	OG
유콘시스템	OG
31일	DT
최진실	PS
60일	DT
윤슬아	PS
이일희	PS
조아람	PS
조영란	PS
홍란	PS
장지혜	PS
김보배	PS
임지나	PS
이창희	PS
Amuse	OG
Pr1zm	OG
Boof	OG
1년5개월	DT
정선희	PS
소공동	LC
롯데호텔	OG
박우열	PS
이종원	PS
김용선	PS
박성환	PS
윤영근	PS
김영주	PS
이효식	PS
체인씨네타운	OG
18-24일	DT
탄종량	PS
(주)금복주	OG
공정거래위원회	OG
CNNSI	OG
지나ㄴ12일	DT
클리퍼스	OG
뉴욕닉스	OG
잭랜돌프	PS
에미레이트항공	OG
두바이	LC
포레스트휘태커	PS
파리	LC
유네스코	OG
이리나보코바	PS
김윤주	PS
니낫	PS
여름철	DT
nL	OG
sNap	OG
감사용	PS
오는2009년6월까지	DT
SKT	OG
현대증권	OG
부저	PS
노원험멜	OG
한규정	PS
공릉배수지	LC
폴	PS
GFK	OG
한국산업기술시험원	OG
KTL	OG
남궁민	PS
국회운영위원회	OG
안상수	PS
2월24일(수)	DT
2월25일(목)	DT
에스티씨라이프	OG
오는29일	DT
충청남도	LC
천안시	LC
서북구	LC
성거읍	LC
정촌리	LC
열흘간	DT
6월15일까지	DT
신생팀	OG
마르코	PS
불교환경연대	OG
수경	PS
실천불교전국승가회	OG
법안	PS
에코붓다	OG
법륜	PS
불교환경	OG
리폰	PS
오ㄹ초	DT
간미연	PS
권	PS
지나ㄴ20일	DT
규슈	LC
조창호	PS
야후코리아	OG
씨네21	OG
올림푸스한국	OG
올림푸스FN코리아	OG
박흥식	PS
심정수	PS
30분간	TI
(주)구성산업	OG
중구청	OG
서ㄹ연휴	DT
이달부터	DT
대신증권	OG
중앙부산	OG
부산2	OG
도민저축은행	OG
8월	DT
광명경찰서	OG
이철구	PS
샌디에이고	OG
2003년11월23일	DT
플로리다말린스	OG
7월31일	DT
지나ㄴ3월31일	DT
포지	PS
우도	LC
지나ㄴ2007년	DT
김태균	PS
모은지	PS
10분내외	TI
표명일	PS
장찬익	PS
김해시	LC
탬파베이	OG
볼티모어	OG
부시	PS
리	LC
좌사리	LC
홍원기	PS
2002시즌까지	DT
매시즌	DT
내야	LC
데라크루즈	PS
푸에르토리코	LC
2006~07	DT
2007~08	DT
신은주	PS
행의정감시연대	OG
여수	LC
여수시	LC
축구협회	OG
조영철	PS
울산학성고	OG
설재문	PS
용인태성고	OG
조범석	PS
신갈고	OG
오는8월부터내년6월까지	DT
10개월간	DT
프랑스1부리그	OG
FC메스	OG
8월3일	OG
로열필하모닉	PS
지나ㄴ1일	DT
E엔터테인먼트	OG
E	OG
오는6월부터	DT
스칼렛	PS
지난달중순	DT
유제국	PS
전태현	PS
김영삼	PS
허	PS
안젤코추크	PS
존	PS
염동균	PS
GS칼텍스	OG
시장단	OG
2010	DT
김C	PS
노홍철	PS
박용택	PS
나흘	DT
오는7월	DT
신민당	OG
네드베트A	PS
십	DT
년간	DT
체코	LC
네드베트	PS
토마시로시츠키	PS
무역협회	OG
오영호	PS
TradeSOS	OG
박광태	PS
박성효	PS
오세훈	PS
E조	OG
정의화	PS
남경필	PS
이병석	PS
롯데그룹	OG
마이데일리	OG
KBS	OG
서효림	PS
6일	DT
포항	LC,OG
최	PS
1997년	DT
예술세계	OG
9일	TI,DT
서구	LC
경서동	LC
경서삼거리	LC
마이애미	LC,OG
현대	OG,DT
성심학교	OG
오후	TI
전국언론노동조합	OG
최상재	PS
MBC본부	OG
한나라당	OG
LG	OG
히트머신	PS
스즈키이치로	PS
시애틀매리너스	OG
김	OG,PS
22일	DT
SK	OG
바이크클리닉	OG
이신미	PS
한국	LC,OG,PS
익산시청	OG
쿠바	LC
아바나	LC
제이콥슨	PS
마리엘자구니스	PS
유선호	PS
민주당	OG
울릉도	LC
삼소도	LC
지난해	DT
한	LC,PS
덴마크	LC
50주년	DT
삼성에버랜드	OG
외환은행	OG
호남	LC
참여당	OG
주	OG
대한성공회	OG
이난희	PS
또르테아	PS
8일	DT
오후1시50분	TI
스포츠서울21	OG
정홍희	PS
13일	DT
3일	DT
27일	DT
26일	DT
㈜혁신전공사	OG
오맹달	PS
류시앙	PS
성내역	LC
한강시민공원	LC
토끼굴	LC
박찬호	PS
버크	PS
마퀸챈들러	PS
12일	DT
오은석	PS
AP통신	OG
올라주원	PS
유잉	PS
애드리언댄틀리	PS
팻라일리	PS
캐시러시	PS
딕바이텔	PS
디트로이트피스톤스	OG
윌리엄데이비드슨	PS
2008	DT
안정환	PS
부산	LC,OG
5일	DT
박지성	PS
더비카운티	OG
이	LC,OG,DT,PS
서부	LC
이명박	PS
10일	DT
해병2사단	OG
2PM	PS
택연	PS
아드리안오웬	PS
日	LC
독도	LC
美	LC
레티프	PS
남아공	LC
상임전국위원회	OG
21일이전까지	DT
제주지방	LC
전년	DT
6월	DT
7월	DT
8월	DT
1	LC,TI,DT
11월	DT
2	OG,DT
12월	DT
캐나다	LC
노먼맥라렌	PS
NormanMclaren	PS
09	TI
00	TI
잉글랜드	LC
맨체스터유나이티드	OG
내일부터	DT
랑핑	PS
중국	LC,OG
1999년	DT
미다스	PS
금호	OG
채권단	OG
올시즌	DT
대한민국	LC
슬로베니아	LC
유산마을	LC
용유임시역	LC
인천공항역	LC
2일	DT
NPD	OG
삼성전자	OG
올해상반기	DT
북미	LC
리처드기어	PS
하치	PS
10년동안	DT
권진규	PS
이선규	PS
국회	OG
평가위원회	OG
통합춘천시체육회	OG
정태섭	PS
내일	DT
최기문	PS
이원석	PS
박재훈	PS
SBS	OG
축구	OG
8월4일	DT
전주시축구협회	OG
무스타파알다비	PS
25일	DT
시리아	LC
김태균	PS
보스톤	LC
케임브릿지플레이스투자운용	OG
CPIM	OG
매사추세츠법원	OG
지나ㄴ9일자	DT
린	PS
부르하누딘라바이니	PS
Rabbani	PS
아프가니스탄	LC
20일	DT
카불	LC
가나	LC
프로팀오크	OG
임마누엘오프리안사	PS
리버티프로페셔널	OG
한신정평가	OG
대림산업	OG
2008년말	DT
2010년말	DT
동부	OG
전창진	PS
SM엔터테인먼트	OG
f(x)	PS
에프엑스	PS
크리스탈	PS
정병국	PS
청와대	LC,OG
박	OG,PS
고지현	LC
오리엔탈호텔	OG
4주	DT
전반기	DT
바르ㄴ전자	OG
FC서울	OG
지나ㄴ2분기	DT
이슬람	OG
니제르	LC
1974~1999년	DT
오늘	DT
두산	OG
김현수	PS
박소연	PS
정성룡	PS
김광모	PS
상무	OG
4분06초47	TI
전주KCC이지스	OG
조웅천	PS
언론노조	OG
정부	OG
전교조	OG
사법부	OG
런던	LC
토트넘	OG
아스널	OG,PS
백설공주	PS
아기돼지	PS
1일	OG,DT
오전	TI
신	PS
국립과학수사연구소	OG
3월25일	DT
덕천2동	LC
김정희	PS
영희	PS
친박연대	OG
서청원	PS
의정부교도소	LC
밀워키	OG
지나ㄴ해	DT
카를로스비야누에바	PS
이종범	PS
황재균	PS
농수산물유통공사	OG
aT	OG
1년전	DT
자크라캉	PS
샘멘디스	PS
UNRiders	OG
리버스	PS
우규민	PS
삼성	OG
안준호	PS
후반	TI
보광티에스	OG
지난달28~29일	DT
퍼거슨	PS
반포매점	OG
점심	TI
양평해장국	OG
조계종	OG
북	LC
조불련	OG
금강산	LC
신계사	LC
현대아산	OG
개성	LC
남북	LC
문학진	PS
하남	LC
행안위	OG
법안소위	OG
경북	LC
상주	LC
경천대	LC
강호동	PS
신동엽	PS
아이비	PS
디초콜릿이앤티에프	OG
아이티	LC
이장연	PS
공보실	OG
업무팀	OG
21일	DT
김지은	PS
추신수	PS
금호산업	OG
이루온	OG
오는25일	DT
오전9시	TI
서울특별시	LC
서초구	LC
양재동	LC
서울교육문화회관	LC
표명일	PS
39분	TI
신지애	PS
유소연	PS
하이마트	OG,PS
10/3~11/20	DT
10월초까지	DT
국제산악회	OG
MBC	OG
8월첫째주	DT
MBCFM	OG
08:35~0910	TI
성내	LC
여의도	LC
최경주	PS
그린	LC
강원	LC
영서지역	LC
2일부터	DT
고성준	PS
15일	DT
남구청	OG
신정시장	LC
1970년대중반	DT
성남	LC,OG
밴버냉키	PS
미	LC
연방준비제도이사회	OG
FRB	OG
하원금융서비스위원회	OG
며칠간	DT
3일부터	DT
피어스	PS
신서울강남7산	LC
친박	OG
브라질	LC,OG
남미	LC
아르헨티나	LC
8년	DT
히딩크	PS
호주	LC
솔로몬제도	LC
팀	OG
A매치데이	DT
에인트호벤	OG
호주대표팀	LC
네덜란드	LC
압구정	LC
12:00	TI
이희근	PS
한화	OG
신경현	PS
심광호	PS
정범호	PS
최연오	PS
프리미어리그	OG
첼시	OG
에버턴	OG
리그	OG
맨체스터	LC,OG
유나이티드	OG
국무부	OG
동해	LC
EastSea	LC
일본해	LC
SeaofJapan	LC
도의회	OG
기획행정위원회	OG
김양호	PS
위원회	OG
전년동월	DT
서인우	PS
도요타	OG
17일	DT
페널티박스	LC
김기동	PS
박원재	PS
조성환	PS
데닐손	PS
장원준	PS
조용태	PS
박현범	PS
크리머	PS
4일	DT
오클라호마주	LC
털사	LC
시더리지CC	OG
줄리잉스터	PS
2005	DT
한국여자대표팀	OG
수원	LC,OG
남동구	LC
부산아이파크	OG
2003년	DT
대신동	LC
사직동	LC
대한의사협회	OG
박형욱	PS
크리스폴	PS
뉴올리언스	OG
샌안토니오	OG
오자와이치로	PS
小澤一郞	PS
리쿠잔카이	OG
도쿄지검특수부	OG
오자와	PS
한국토지주택공사	OG
LH	OG
류중탁	PS
남자배구대표팀	OG
오는31일	DT
도쿄	LC
62	DT
08:35~09:10	TI
두달전	DT
우즈	PS
스카이72골프장	OG
오션코스	LC
김동주	PS
23일	DT
김재환	PS
토요타	OG
1월21일	DT
팔메이로	PS
문화체육관광부	OG
18일	DT
오사카	LC
박영혜	PS
카자흐스탄	LC
위명재	PS
이탈리아	LC,OG
스위스	LC
KT＆G	OG
동양	LC
지나ㄴ1년6개월간	DT
에버트	PS
노먼은	PS
태릉선수촌양궁장	OG
윤	PS
김신영	PS
삼일제약	OG
서태지와아이들	PS
YG엔터테인먼트	OG
양현석	PS
18일이	DT
YG	OG
히틀러	PS
산은	OG
전반전	TI
전남	LC,OG
45분	TI
농협	OG
하나로마트	OG
설	DT
지난달말부터	DT
하	LC,OG,DT,PS
팬텀	OG
재건축추진위	OG
당	LC
폭스	OG
시마노	OG
LA레이커스	OG
한국산핵잠수함	PS
김병현	PS
콜로라도로키스	OG,PS
동방신기	PS
미스터칠드런	PS
퍼퓸	PS
국민신당	OG
150분	TI
9000초	TI
원주	LC,OG
국민건강보험공단	OG
한국교육개발원	OG
한국교육과정평가원	OG
한국농촌경제연구원	OG
개	OG
홈플러스	OG
22일부터	DT
2007년	DT
베이징	LC
北京	LC
한여름	DT
제주	LC,OG
국회법제실	OG
애프터스쿨	PS
유이	PS
NS	OG
WKBL	OG
전날	DT
미래에셋는	OG
금융감독원	OG
피노키오론	OG
안젤코	PS
삼성화재	OG
현대캐피탈	OG
현경	PS
보석	PS
한국수출입은행	OG
김용환	PS
남기섭	PS
김학민	PS
최나연	PS
13일부터사흘간	DT
제주도	LC
테디밸리골프장	OG
방문진	OG
지나ㄴ30여년간	DT
베니스	LC
카사노바	PS
한한국	PS
8월2일일요일2009년	DT
Light사	OG
장미란	PS
윤진희	PS
2.15(월)	DT
설연휴	DT
박희수	PS
추	PS
안철수연구소	OG
김홍선	PS
박동희	PS
경북도	LC
2008년도4분기	DT
지난해3분기	DT
화요	DT
당일	DT
금남정맥	LC
지난해10월말	DT
1년이상	DT
지나ㄴ2008년말	DT
지나ㄴ시즌	DT
GS칼텍스	OG
금주산	LC
포천	LC
2010	DT
속초	LC
이상민	PS
의정부시	LC
버버리	OG
다음달	DT
오초아	PS
문성민	PS
A	OG,PS
지난달말	DT
독일	LC,OG
1부리그	OG
프리드리히샤펜	OG
경기대	OG
대한배구협회	OG
19일	DT
한국은행	OG
대전	LC,OG
충남	LC
오재권	PS
대구	LC
외자운용원	OG
후쿠시마	OG,PS
이달부터	DT
제주지역	LC
한해	DT
앨런	PS
J리그	OG
정대세	PS
긱스	PS
서원선	PS
총선	OG
강화군	LC
김인식	PS
1985년	DT
1992년	DT
스포츠서울닷컴	OG
윌리엄스	PS
부저	PS
LG화학	OG
올해1분기	DT
아더패터슨	PS
조용필	PS
상반기	DT
하반기	DT
29일	DT
오전11시	TI
그랜드하얏트호텔	OG
10년	DT
mYTV21	OG
윤현숙	PS
경찰	OG
타깃	OG
암스테르담	LC
영국대사관	OG
모비스	OG
전형수	PS
제6주	DT
블룸버그통신	OG
혼다자동차	OG
2005년11월부터지난해6월까지	DT
MOU	OG
유원상	PS
이범호	PS
KIA	OG
알렉스퍼거슨	PS
박희진	PS
페네르바체	OG
보스턴	LC,OG
애틀랜타	OG
시의회	OG
선거구획정위원회	OG
인천	LC,OG
정이수	PS
선우미디어	OG
여자핸드볼대표팀	OG
김진수	PS
핸드볼협회	OG
페더러	PS
4월28일	DT
로마	LC
5일12일	DT
스페인	LC
마드리드	LC,OG
의정부	LC
동두천	LC
남양주	LC
포천시	LC
가평군300	LC
중동	LC
이란	LC
김학영	PS
감나무집	OG
겨울	DT
지난달25일부터	DT
원빈	PS
오는10일부터	DT
현대기아차	OG
기아차	OG
지나ㄴ10일	DT
이번주	DT
권경률	PS
안선주	PS
선덜랜드	OG
한국타이어	OG
엠케이테크놀로지	OG
4월	DT
김연수	PS
지암산악회	OG
수	DT,PS
친박계	OG
류재림	PS
檢	OG
강남	LC,OG
루이제프리베리	PS
한송이	PS
도로공사	OG
KOVO	OG
한국프로배구연맹	OG
신화	PS
신혜성	PS
16일	DT
문대성	PS
1박	DT
1980년대	DT
선거구	LC,OG
계양1선거구	LC
랄프윈터	PS
6자회담	OG
할리우드	LC
톰크루즈	PS
지나ㄴ16일	DT
파리	LC
케이티홈즈	PS
22시	TI
김정숙	PS
탕	PS
지나ㄴ2003년4월	DT
홍콩	LC
장쩌민	PS
江澤民	PS
올림픽대표팀	OG
박성화	PS
올림픽	OG
어제	DT
화도진도서관	OG
최용백	PS
도미니카	LC
이모	PS
코도카포럼	OG
후세인레자자데	PS
오는22일	DT
김회장	PS
춘천	LC,OG
유	PS
강원도	LC
21세기	DT
솔비	PS
류승완	PS
김지운	PS
야코프프로타자노프	PS
신천중	OG
4시간	TI
마야	PS
쥬얼리	PS
세종시	LC
충청권	LC
소렌스탐	PS
하루	DT
국민은행	OG
김포	LC
고양	LC
할렐루야	OG
익산	LC
안산	LC
04년도7월	DT
서강대	OG
2020	DT
장종훈	PS
길리어드사이언스	OG
이승우	PS
조동건	PS
지나ㄴ6일	DT
김주성	PS
김형오	PS
부평구	LC
박윤배	PS
재향군인회	OG
부평구지회	LC
지나ㄴ11월26일	DT
부평구청	OG
1년	DT
이원희	PS
대한항공	OG
지난달13일	DT
설문대여성문화센터	OG
상임위	OG
카젠버그	PS
디즈니	OG
오소영	PS
조동진	PS
장필순	PS
박민일	PS
주문진항	LC
니베아	OG
남양유업	OG
CJ	OG
에두	PS
두두	PS
올	DT
염기훈	PS
신영록	PS
김성근	PS
요미우리	OG
ktcs	OG
31일	DT
미셸위	PS
양희영	PS
20:20	TI
남북한	LC
로저페더러	PS
후쿠하라아이	PS
장성호	PS
메이저리그	OG
전날이	DT
28일	DT
고링호텔	OG
케이트미들턴	PS
캐롤	PS
피파	PS
고	OG,PS
1974년8월6일	DT
저녁	TI
필리프	PS
유럽연합	OG
4	DT
월	DT
5~	DT
이시이	PS
원더걸스의	PS
유빈	PS
선미	PS
토드배크먼	PS
미국남자배구대표팀	OG
휴매커천	PS
2004년	DT
배구대표	OG
엘리자베스위즈배크먼	PS
미국남녀배구대표팀	OG
김호철	PS
싼토리	OG
경기도팔당수질개선본부	OG
11일	DT
베트맨	OG
26일까지	DT
오ㄹ시즌	DT
캔디스퍼트는	PS
2008년6월말	DT
닥스골프	OG
GG사토	PS
NBA	OG
조권	PS
가인	PS
하나회	OG
우리법연구회	OG
전현직	PS
호나우두	PS
1982년	DT
광주	LC,OG
동군	OG
김용철	PS
김용희	PS
윤동균	PS
서군	OG
김일권	PS
임호	PS
마해영	PS
이번설연휴	DT
새벽4시부터	TI
새벽4시까지	TI
감나무재	LC
8시간	TI
2009년10월22일	DT
매주목요	DT
안성	LC
칠장산	LC
속리산	LC
천황봉	LC
2009년12월31일	DT
하나관광버스	OG
랫소	PS
스티브잡스	PS
지나ㄴ5일	DT
닉	PS
14일	DT
오전7시부터자정까지	TI
낮부터저녁시간대까지	TI
자정부터	TI
정몽구	PS
현대자동차그룹	OG
김포공항	LC
후진타오	PS
코비	PS
풍경	PS
영진약품공업	OG
내달18일	DT
오전10시	TI
서울시	LC
강동구	LC
성내2동	LC
엘웨딩	OG
로드리고	PS
1597년	DT
1873년	DT
이화여고	OG
100주년	DT
0708	DT
포스퀘어	OG
천	LC,PS
뉴사운드처치	OG
EA스포츠	OG
10월10,	DT
오서산	LC
서해	LC
주능	LC
성현리	LC
성골주차장	LC
광천젓갈시장	LC
서해바다	LC
충남,	LC
광천	LC
7	TI,DT
,	DT
수자원공사	OG
수공	OG
현대건설	OG
퍼시픽리그	OG
원주동부	OG
안양KT&G	OG
7일	DT
오후7시	TI
오후2시10분	TI
안양	LC,OG
오후3시	TI
심사위원회	OG
지난달	DT
한신평	OG
대우건설	OG
발렌타인데이	DT
행정안전부	OG
국무회의	OG
매일유업	OG
지나ㄴ7월초부터	DT
서희태	PS
부산대학교	OG
밀양캠퍼스	OG
4년째	DT
LIG손해보험	OG
마산	LC
손민한	PS
윤석민	PS
오는19일	TI,DT
어셔	PS
2008년3월	DT
본프레레	PS
태욱	PS
전주	LC,OG,DT
MK홀딩스	OG
인토외식사업	OG
박진	PS
김양제	PS
종로	LC
경찰서	OG
10분	TI
도평리	LC
춘자	PS
설운도	PS
장	PS
지나ㄴ96년	DT
해양수산부	OG
천안	LC,OG
경주	LC
보성	LC
정운찬	PS
우리캐피탈	OG
13년	DT
지나ㄴ2005년	DT
TG	OG
크라이슬러	OG
천호	LC
잠실	LC
나르샤	PS
여름	DT
SK텔레콤	OG
4월중	DT
아침	TI
우지원	PS
원	LC,PS
전주영상위원회	OG
중국슈퍼리그	LC
창춘	OG
E조	OG
후반40분	TI
이방호	PS
김성호	PS
골든스테이트	OG
러시아	LC
최정	PS
대한축구협회	OG
축구리그	OG
K3리그	OG
이대호	PS
탐라자치연대	OG
삼매봉	LC
공동선대	OG
시민공원	LC
국민권익위원회	OG
삼매봉공원	LC
서울종합예술학교	OG
박성호	PS
이동엽	PS
이멜만	PS
둘째날	DT
장근석	PS
50년	DT
모토로라	OG
지나ㄴ2006년	DT
노키아	OG
E1	OG
이달	DT
인천시	LC
올상반기	DT
오는2012년까지2	DT
연합	OG
5월3일	DT
이승엽	PS
곤도	PS
허친슨	OG
10월	DT
금아플로어	OG
현대ㆍ기아차	OG
한국차	LC
최희섭	PS
서재응	PS
주산지	LC
40분	TI
절골	LC
가매봉	LC
사창골	LC
제3,2,1폭포	LC
5시간30분	TI
프라임MD	OG
오는10월부터11월까지	DT
2013학년도	DT
박찬욱	PS
금자	PS
청주	LC
2002-03시즌부터	DT
이병규	PS
콜로라도	OG
24일	DT
우리	OG
이택근	PS
유럽	LC
한국통신프리텔	OG
한솔PCS	OG
LG텔레콤	OG
PCS	OG
김지영	PS
김용림	PS
2005년12월경	DT
2006년3월경	DT
화요일마다	DT
구청	OG
라고스	LC
봉중근	PS
KBSTV	OG
10ㆍ26	DT
나경원	PS
야권	OG
제임스	PS
엘렌노르데그렌	PS
박경완	PS
조동화	PS
남궁연	PS
국립자연사박물관	OG
이승태	PS
03/03	DT
16:14	TI
무박	DT
사회당	OG
1950년	DT
5.30	DT
성북구	LC
1958년9월	DT
페널티에어리어	LC
왈콧	PS
이원진	PS
1997년3월12일	DT
LA	LC
문동환	PS
플라마	OG
4월16일	DT
강준만	PS
전북대	OG
신문방송학과	OG
조선시대	DT
방승환	PS
곽태휘	PS
지난달8일	DT
레스	PS
함평군	LC
버락오바마	PS
2011년	DT
세원테크	OG
디비정보통신	OG
시그넷시스템	OG
미래엔	OG
웅진패스원	OG
티맥스소프트	OG
KT파워텔	OG
90분	TI
3월	DT
가나마루유스케	PS
최민호	PS
03/04	DT
Buzrun	OG
극동지역	LC
이르쿠츠크	LC
총영사관	OG
부천영화제사무국	OG
내달3일	DT
오후3시30분∼5시30분	TI
부천	LC,OG
중앙공원	LC
왕자루이	PS
북한	LC
린파스코	PS
유엔	OG
2005년이후	DT
광주일고	OG
안산시	LC
지나ㄴ12일	DT
권	PS
경기도공동모금회	OG
웅진홀딩스	OG
오는18일	DT
빅뱅	PS
승리	PS
금주	DT
박명환	PS
지나ㄴ1일	DT
레이커스	OG
죽장면	LC
상옥리	LC
산2-2번지	LC
경상북도수목원	LC
오전10시부터오후5시	TI
동절기	DT
오후4시	TI
다음날	DT
아데바요르	PS
유승호	PS
고아성	PS
2011	DT
광주김치타운	LC
인천로봇랜드	LC
장한섬	PS
지나ㄴ2008년	DT
씨알	PS
인천아트플랫폼	OG
스페이스빔	OG
플레이캠퍼스	OG
비제이싱	PS
피지	LC
강원래	PS
송이	PS
배상문	PS
캘러웨이	OG,PS
지난해4월	DT
니트젠테크놀로지	OG
엔피아	OG
한달뒤	DT
5월	DT
개나리벽지	OG
현대백화점부산점	OG
이기용	PS
오는26일	DT
토	DT
K	OG
이형두	PS
이천수	PS
울산현대	OG
센트럴리그	OG
파리바게뜨	OG
파리크라상	OG
김응룡	PS
수도권	LC,OG
국회의원회관	OG
조	OG,PS
2008년3월17일	DT
688일	DT
조동현	PS
이숙영	PS
10년간	DT
한국로버트보쉬	OG
전동공구사업부	OG
스킬전동공구	OG
올시즌부터	DT
티베트	LC
달라이라마	PS
1시간	TI,DT
우리나라	LC,OG
씨모텍	OG
임수혁	PS
이미나	PS
KTF	OG
배경은	PS
소퍼코스	LC
아니카소렌스탐	PS
스웨덴	LC,PS
아키오	PS
하원	OG
정부개혁위원회	OG
이주일	PS
형곤	PS
서울통신기술	OG
김정묵	PS
EPL	OG
국립산림과학원	OG
올겨울	DT
이번시즌	DT
공원관리계	OG
김성희	PS
지난해말	DT
주말	DT
친이	OG
3월초순	DT
중진협의체	OG
일주일	DT
친이계	OG
맨시티	OG
아담존슨	PS
테베스	PS
전반	TI
강서구	LC
롯데주류	OG
충북	LC
충북소주	LC
양장수	PS
04/05	DT
21:47	TI
물개바위	LC
슈	PS
선관위	OG
한국신용평가	OG
대한전선	OG
신용	OG
거북이이	PS
위창수	PS
테일러메이드	OG
첫날	DT
치악산	LC
설악산	LC
한계령	LC
지난달4일	DT
에메르손	PS
같은달22일	DT
벤호건	PS
오는23일	DT
배	PS
서울아산병원	OG
배삼룡	PS
9월1일	DT
용덕한	PS
정수근	PS
1879년	DT
LarsNilson	PS
김정남	PS
케빈듀란트	PS
시애틀수퍼소닉스	OG
전반34분	TI
이규로	PS
페널티지역	LC
김치우	PS
욕지도	LC
사량도	LC
한산도	LC
가희	PS
이승기	PS
김준호	PS
농심	OG
조코비치	PS
청주리포트	OG
양경민	PS
강하	PS
양익	PS
1991년	DT
1995년	DT
중앙승가대	OG
괴산	LC
클리블랜드	OG,PS
클리프리	PS
공정위	OG
FTC	OG
새벽에서	TI
아침까지	TI
새벽녁	TI
아	OG,TI
한국일보	OG
대관령	LC
진부면	LC
청소년리더십아카데미	OG
복지문화회관	OG
용평면	LC
봉평면	LC
스포츠콤플렉스	OG
기상청	OG
동부지역	LC
경남제약	OG
오28일	DT
경기도	LC
상록구	LC
사동	LC
박미희	PS
권익위	OG
이재오	PS
서울시교육청	OG
천지일보	OG
뉴스천지	OG
황인춘	PS
토마토저축은행	OG
1990년대	DT
황우여	PS
권호영	PS
오현경	PS
손기철	PS
지나ㄴ5월29일	DT
K-리그	OG
도화성	PS
임관식	PS
김재영	PS
이정효	PS
이장관	PS
김유진	PS
배효성	PS
박준홍	PS
일본대표팀	LC,OG
김연경	PS
4월9일(수)	DT
오대산	LC
백두대간	LC
가ㄹ전곡봉	LC
개인산	LC
JYP	OG
오ㄹ4월	DT
재범	PS
이동미	PS
생각의나무	OG
후반12분	TI
울산	LC,OG
안영학	PS
70일	DT
황재원	PS
유로파이터	OG
영국	LC
보잉	OG
록히드마틴	OG
시큐브	OG
특허	OG
PCT	OG
PatentCooperationTreaty	OG
특허협력조약	OG
2005년	DT
지난해11월20일	DT
평창	LC
관광산업경쟁력강화회의	OG
2018	DT
이노근	PS
노원	LC
밴쿠버	LC
13일전	DT
2박3일	DT
4박5일	DT
매주월,수,금	DT
인천항	LC
이틀	DT
대구락밴드연대	OG
2010-02-24	DT
03:35:38	TI
야오밍	PS
전북	LC,OG
하대성	PS
장남석	PS
유승준	PS
추창민	PS
진종오	PS
국토해양부	OG
다임러사	OG
다임러오토모티브한국	OG
감사원	OG
수도권매립지관리공사	OG
2009년9월	DT
폴크스바겐	OG
브라질법인	OG
하나포스닷컴	OG
코원시스템	OG
(주)볼보자동차코리아	OG
명성산	LC
鳴聲山	LC
광덕산	LC
廣德山	LC
국망봉	LC
國望峰	LC
박원순	PS
독일팀	OG
과외방	OG
스카이디지탈	OG
배정식	PS
지나ㄴ1월	DT
지나ㄴ	DT
시즌	DT
송승준	PS
승	PS
후반기	DT
김한수	PS
오성진	PS
투자컨설팅센터	OG
대법원	OG
폴란드	LC
세르비아	LC
길은정	PS
오늘부터	DT
프리시즌	DT
미래에셋자산운용	OG
호라이즌베타프로	OG
BetaPro	OG
지나ㄴ2년	DT
영등포역사	LC
롯데백화점	OG
쯔리겐	OG
로이스터	PS
광주시	LC
그린벨트	LC
3일간	DT
한희원	PS
휠라코리아	OG
의총	OG
인터파크	OG
I-pmc-	OG
무등산	LC
등	LC
CEO명품아카데미	OG
중소기업청	OG
토요일	DT
5개월동안	DT
예니볼프	PS
0.06초	TI
지나ㄴ18일	DT
벽산건설	OG
이효리	PS
김제동	PS
김태완	PS
코레일	OG
대전충남본부	OG
강해신	PS
영동관리역	LC
김봉회	PS
오전10시부터	TI
영동역	LC
전북은행	OG
한반도	LC
2008-2009	DT
V리그	OG
클락	PS
강	PS
2007년이후	DT
2년	DT
10년전부터	DT
오바마	PS
진	PS
주호영	PS
박근혜	PS
경주시민축구단	OG
고양시민축구단	OG
통영	LC,OG
동아	OG
메릴랜드주	LC
하브드그레이스	LC
불록골프장	OG
스포츠	OG
마쓰이	PS
메이저리그사무국	OG
2월초	DT
지난해12월말	DT
김홍준	PS
정초신	PS
오는2016년까지	DT
8년간	DT
전솔	PS
중앙초	OG
묵호초	OG
오후1시	TI
태백	LC
실링	PS
쟈니고메스	PS
페르난도코르테스	PS
토비홀	PS
18일째	DT
양승조	PS
강진	LC
박지은	PS
김혜윤	PS
3분여전	TI
브라이언트	PS
제주일보	OG
김홍철	PS
김한섭	PS
최병석	PS
버크너	PS
1986년	DT
뉴욕	LC,OG
메츠	OG
6	DT
장쯔이	PS
서기	PS
송시헌	PS
양현재단	OG
최은영	PS
한진해운	OG
이주헌	PS
예술마을헤이리	LC
임경수	PS
울산대학교	OG
의과대학	OG
아산병원	OG
강익중	PS
송보배	PS
2008년	DT
정두언	PS
오비맥주	OG
15일부터	DT
대우증권	OG
8월둘째주	DT
8~12	DT
제일모직	OG
CJCGV	OG
CJ오쇼핑	OG
김용대	PS
버지니아	LC
인방사	OG
인천경제청	OG
인사위원회	OG
광고물관리심의위원회	OG
건축위원회	OG
도시경관자문위원회	OG
한국도로공사	OG
김해란	PS
한국영화진흥위원회	OG
오는22일부터	DT
TESCO	OG
소방서	OG
테크노세미켐	OG
2007.2.5	DT
이영표	PS
U20청소년대표팀	OG
삼성電	OG
44년	DT
D조	OG
월요일	DT
금요일	DT
일요일	DT
낮	TI
일	LC,DT
조동찬	PS
하ㄴ달간	DT
테렌스레더	PS
써튼	PS
전월	DT
4월초	DT
DATV	OG
제임스캐머런	PS
봉준호	PS
이경수	PS
내곡	LC
아침7시	TI
중반부터	TI
인천지역	LC
2010년	DT
계양산	LC
골프장	LC
법무부	OG
김기용	PS
양익준	PS
임진모	PS
홍서범	PS
틴틴파이브	PS
이동우	PS
브라운아이드걸스	PS
제아	PS
박준형	PS
카라	PS
규리	PS
김민지	PS
베트남	LC
보령메디앙스	OG
워싱턴	LC,OG
퓨어가닉	OG
KT	OG
SK브로드밴드	OG
LG데이콤	OG
방송통신위원회	OG
페어웨이	LC
천안시청	OG
전반44분	TI
후반19분	TI
김관욱	PS
김준식	PS
노희용	PS
인천코레일	LC,OG
강성훈	PS
삼정호텔	OG
동해안	LC
벨라판	PS
아시아	LC
중앙시네마	OG
브제티슬라브포야르	PS
여자대표팀	OG
베오그라드	LC
프랑스	LC
전후반90분	TI
김종민	PS
19-20일	DT
스티브슈몰	PS
상하이	LC
무주리조트	OG
장정	PS
2그룹	OG
디트로이트	OG
올랜도	OG
안상수	PS
최고위원회의	OG
오후10시	TI
최민식	PS
송강호	PS
렉시	PS
지누션	PS
빅마마	PS
마스터우	PS
YG언더그라운드	OG
45RPM	PS
스토니스컹크	OG
소울스타	OG
신데렐라	PS
천정명	PS
문근영	PS
서우	PS
5분뒤	TI
우면산	LC
관악산	LC
삼성산	LC
14:	TI
22:00	TI
김창규	PS
서ㄹ연휴	DT
휴일	DT
설연휴동안	DT
정	PS
고현	LC
일하는세상	OG
동남권신공항	LC
허브공항	LC
20:49:26	TI
한전	OG
전일	DT
김준희	PS
소녀시대	PS
송승헌	PS
션	PS
2년전	DT
정승혜	PS
지나ㄴ2006년부터	DT
지나ㄴ달	DT
고대안암병원	OG
오전10시38분	TI
댄웰던	PS
문희	PS
현	PS
수리	PS
페라가모	OG
노장진	PS
권오준	PS
그리스	LC
2분20초전	TI
AFC	OG
올댓시네마	OG
브래드피트	PS
오는14일	DT
시카고컵스	OG
100년	DT
네패스	OG
조명시장	LC
해태	OG
김성한	PS
연장	TI
황규봉	PS
작년	DT
김영식매일경제신문사	PS
아이	LC
티찌아노테르짜니아	PS
인하대	OG
LG디스플레이	OG
2분기분기	DT
지나ㄴ주말	DT
요미우리이승엽	PS
임창용	PS
카리모프	PS
지난해5월	DT
우즈베키스탄	LC
백보람	PS
정가은	PS
루피넬라	PS
장훈	PS
삼척지역	LC
만해	PS
총독부	OG
겨울철	DT
데이	PS
김선우이	PS
김선우	PS
안정개발	OG
장문리	LC
이보영	PS
화천119안전센터	OG
김교성	PS
오는가을	DT
섀넌	PS
KBL	OG
지나ㄴ주	DT
클리프	PS
브룸바	PS
태민	PS
카드	OG
암웨이	OG
현대카드M	OG
신한카드	OG
한국암웨이	OG
쇼핑몰ABN	OG
암웨이플라자	OG
내셔널리그	OG
제이크피비	PS
샌디에이고파드리스	OG
페드로마르티네스	PS
뉴욕메츠	OG
예선A조	OG
2월24일(토요일)	DT
2년째	DT
마쓰자카다이스케	PS
지나ㄴ2일	DT
Dice-K	PS
션피긴스	PS
6개월간	DT
지난해11월	DT
동안구	LC
관양동	LC
심정수	PS
박용택	PS
동부컨퍼런스	OG
뉴저지네츠	OG
토론토랩터스	OG
포스트시즌	DT
이광환	PS
雪嶽山	LC
대청봉	LC
25時산악회	OG
화천군	LC
지역농협	OG
맞춤형비료운영위원회	OG
텍사스레인저스	OG
LA에인절스	OG
조광래	PS
3년후이ㄴ	DT
2013년	DT
집행위원회	OG
김호기	PS
동부화재	OG
2009년6월말	DT
지난해6월말	DT
올해6월말	DT
김연아	PS
곽민정	PS
준호	PS
파스코	PS
주니치	OG
히로시마	OG
평양	LC
마카오	LC
60초	TI
무노	PS
Muno	PS
내년	DT
몽돌해안	LC
포천군	LC
이동면	LC
철원군	LC
서면	LC
늦겨울까지	DT
관악구	LC
강경남	PS
3월초	DT
의원총회	OG
중	LC,OG
이석채	PS
2011년도	DT
우면동	LC
임경식	PS
윤성만	PS
그리브	PS
5일전	DT
허인회	PS
기아	OG
지식경제부	OG
에너지관리공단	OG
2008년도	DT
강원대학교	OG
부산시교육청	OG
허	PS
김호	PS
지나ㄴ14일	DT
열흘간	DT
금강	LC
인천시교육청	OG
정진석	PS
김수환	PS
첫해	DT
2006-07시즌	DT
2007년8월	DT
노스햄튼	OG
비트컴퓨터	OG
조현정	PS
전진옥	PS
지나ㄴ2002년	DT
엠블랙	PS
후인정	PS
하경민	PS
김미현	PS
브라운	PS
히어로즈	OG
빌보드뮤직어워드	OG
3월31일	DT
2006년12월31일	DT
천호동	LC
2007년1월1일	DT
2007년12월31일	DT
한강	LC
용강동	LC
뉴욕증시	OG
벤버냉키	PS
연방준비제도	OG
남양주시	LC
안성시	LC
화성시	LC
페르시아	LC
부산銀	OG
에스케이텔레콤	OG
신세기통신	OG
2001년	DT
박항서	PS
전남드래곤즈	OG
캘리포니아	LC
노동부	OG
뉴욕양키스	OG
카야핸드슨	PS
미셸리	PS
2월	DT
임시국회	OG
강민호	PS
순천	LC,OG
강호선	PS
한국야구대표팀	OG
한국통신학회	OG
기관장협의회	OG
장효조	PS
삼성라이온즈2군	OG
최광수	PS
동아제약	OG
강욱순	PS
김상식	PS
다저스	OG
켄트	PS
남구	LC
1955년	DT
유엔총회	OG
유엔묘지	OG
지	LC,DT,PS
동대문구	LC
그린데이	PS
GreenDay	PS
후반17분	TI
곽희주	PS
광주시의회	OG
구	LC,PS
CGV	OG
맥스무비	OG
준지	OG
EJT	OG
비틀스	PS
방동약수	LC
적가리	LC
시엠	OG
지나ㄴ겨울	DT
본인	OG
미들즈브러	OG
차이코프스키	PS
5월달	DT
초	DT
조명남	PS
공항동	LC
MC몽	PS
하ㄴ	PS
호석	PS
현대증권	OG
임태경	PS
권재진	PS
한상대	PS
영우데코	OG
2월20일부터	DT
영화진흥위원회	OG
지난해초	DT
올해초	DT
나이키골프	OG
진준택	PS
캐논코리아컨슈머이미징㈜	OG
고아라	PS
김수현	PS
6월1일부터	DT
지경부	OG
오전11시16분	TI
팍스리광산	LC
카멜사	OG
프리드리히스하펜	OG
정숙희	PS
가넷	PS
스포츠토토상품운영부	OG
박인호	PS
치악산호랑이	PS
가르시아	PS
김성인	PS
방산초	OG
영월	LC
옥동초	OG
기아자동차	OG
자동차	OG
원더랜드사	OG
타이거우즈	PS
웽거	PS
로버트드니로	PS
박수혁	PS
부산일보사	OG
동의대학교	OG
부속한방병원	OG
에너지경제연구원	OG
오는17일	DT
그린프리미엄	OG
김경문	PS
백민철	PS
5년후	DT
폴라크리머	PS
주중	DT
KT&G	OG
주희정	PS
지은희	PS
페테르센	PS
해저드	LC
LG전자	OG
현영	PS
블룸버그뉴스	OG
인텔	OG
AMD	OG
7월23일	DT
3~5년후	DT
지나ㄴ2007년11월15일	DT
홍은동	LC
그랜드힐튼호텔	OG
안현식	PS
비	PS
MTV	OG
광산김씨	OG
대교동파	OG
은태공문	OG
김재호	PS
피닉스	OG
지나ㄴ2월	DT
서부컨퍼런스	OG
숀매리언	PS
오닐	PS
리솜리조트	OG
서환석	PS
리샤드	PS
미셀	PS
김재훈	PS
동남권	LC
위례신도시	LC
이달말	DT
하승진	PS
3월4일	DT
90일전	DT
3년	DT
지나ㄴ시즌부터	DT
대우자동차판매㈜	OG
2009~2010	DT
이주영	PS
leejy96	PS
서정진	PS
홍진섭	PS
윤호영	PS
정영삼	PS
전자랜드	OG
4분여전	TI
오는21일	DT
내년1월1일부터	DT
2008-09	DT
사흘	DT
중구	LC
소공동	LC
롯데호텔	OG
4월4일(토)	DT
지난해7월부터올해2월까지	DT
다음달19일까지	DT
펠릭스로흐	PS
지미롤린스	PS
메멧오쿠어	PS
두산인프라코어	OG
삼성전기	OG
디스플레이서치	OG
2분기	DT
오	DT,PS
한국올림픽대표팀	OG
슈텔리안모쿠레스쿠	PS
김봉수	PS
미코오이바넨	PS
선인완궈증권	OG
닝보은행	OG
니아발다로스	PS
존코벳	PS
20세기폭스	OG
베크맘베토브	PS
TimurBekmambetov	PS
고양시	LC
일산	LC
식사지구	LC
대한주택협회	OG
대한주택건설협회	OG
빈스	PS
에이미	OG,PS
존	PS
10년후	DT
서귀포시	LC
동양종금證	OG
하주	LC
한양MTB	OG
정찬헌	PS
가나항공사	OG
스카이프	OG
한달	DT
정말순	PS
한국배구연맹	OG
9월6~19일	DT
일주일간	DT
양키스	OG
백도가	LC
마라도	LC
가파도	LC
거문도	LC
시드니	LC
거	LC
시	LC,TI
폰세카	PS
11:30	TI
지구	LC
인권위	OG
경찰지휘부	OG
디트로이트뉴스	OG
오는6월부터	DT
북한산	LC
인수봉	LC
미군	OG
영유아기	DT
하나호텔	OG
서울행정법원	OG
아바	OG
하춘수	PS
LG전자주	OG
삼성SDI	OG
성호전자	OG
크로바하이텍	OG
유아이디	OG
다윈텍	OG
대주전자재료	OG
하이닉스	OG
디나라사피나	PS
6주	DT
최점숙	PS
최용길	PS
유영근	PS
지나ㄴ95년	DT
스티븐스필버그	PS
데이비드게펜	PS
드림웍스	OG
마이다스의손	PS
2주년	DT
G20정상회의	OG
올해말	DT
레이존론도	PS
폴피어스	PS
켄드릭퍼킨스	PS
오후7∼10시	TI
로레나오초아	PS
멕시코	LC
최지우	PS
구호	OG
30일	DT
지나ㄴ2007년	DT
양양	LC
노수현	PS
조원량	PS
국립농수산물관리원	OG
국립식물검역원	OG
28일까지	DT
AS로마	OG
로시	PS
대한	OG,DT
5일부터입춘전3일까지	DT
78일간	DT
중부	LC
영남	LC
김민경	PS
2년간	DT
지나ㄴ3일	DT
새벽3시	TI
한국국제협력단	OG
KOICA	OG
라이온즈오버뮬러	OG
트윈스	OG
도싸	OG
이승철	PS
윤종대	PS
부산스포원	OG
다음달1일까지	DT
다음달3일	DT
대한농구협회	OG
포천시의회	LC
육군제6군단	OG
포천교육청	LC
포천시체육회	LC
문수영	PS
밉ㄴ오리새끼	PS
최태웅	PS
이규섭	PS
퀘타슈라	OG
파키스탄	LC
퀘타	OG
슈라	OG
정보당국	OG
탈레반	OG
로커스트힐CC	OG
김경련	PS
안성시청	OG
이재은	PS
오피넷	OG
화천읍	LC
중리	LC
주혜진	PS
서인영	PS
스코틀랜드	LC
포터필드	PS
지나ㄴ88-93년	DT
잠비아	LC
짐바브웨	LC
오만	LC
트리니다드토바고	LC
북중미	LC
三煥기업	OG
반월	LC
韓寶철강	OG
금요비	PS
작년10월말경	DT
동피랑	LC
1주일간	DT
통영시	LC
인왕산	LC
김동수	PS
내설악	LC
백담계곡	LC
수렴동계곡	LC
백운동계곡	LC
가야동계곡	LC
와룡	LC
유달	LC
쌍폭	LC
대승	LC
이현숙	PS
루베이다던포드	PS
지나ㄴ8일부터	DT
월~금	DT
오후5시35분	TI
다	LC,OG,DT,PS
김정아	PS
양구중	OG
남춘천여중	OG
피사로	PS
삼성SDI컨소시엄	OG
박진형	PS
MB	PS
송일국	PS
화왕산	LC
백	PS
UBCARE	OG
김진태	PS
엠디하우스	OG
홍	PS
중앙선거관리위원회	OG
국제축구연맹	OG
FIFA	OG
이승호	PS
앤서니김	PS
온타리오주	LC
오크빌	LC
글렌애비GC	OG
알제리	LC
미들스브러	OG
가레스사우스게이트	PS
이브닝가제트	OG
강원도청	OG
프로연맹	OG
김경태	PS
이동수골프단	OG
함영애	PS
김민선	PS
코오롱엘로드	OG
김하늘	PS
윤지원	PS
임지선	PS
케이앤컴퍼니	OG
코스닥	OG
최주영	PS
신한은행	OG
지나ㄴ9일까지	DT
아레나스	PS
우기정	PS
2박3일간	DT
다롄	LC
랴오닝성골프협회	OG
리융진	PS
미키캘러웨이	PS
지나ㄴ3월	DT
17~25일	DT
지나ㄴ2000년이후	DT
지난해연말	DT
빌럽스	PS
플로리다주	LC
올랜도매직	OG
4분	TI
정상호	PS
1분	TI,DT
푸르넷	OG
스포츠서울	OG
닷컴	OG
환경부	OG
6일부터	DT
덴버	OG
케넌	PS
16	DT
마리안	PS
KCC	OG
서장훈	PS
제주YWCA민들레학교	OG
겨울동안	DT
오후5시57분	TI
달	LC,DT
이성희	PS
정대영	PS
황연주	PS
창작스튜디오	OG
네스터로빅	PS
6일까지	DT
박재홍	PS
2008-09시즌	DT
겟엠	OG
한규웅	PS
문병호	PS
동계	DT
하계	DT
(주)한조	OG
정용화	PS
서현	PS
찻	OG
타이	OG
태국	LC
추윗	PS
황	PS
50분	TI
월풀	OG
김송희	PS
7공주	PS
여성가족부	OG
지난해12월22일	DT
한국전자통신연구원	OG
충남지역	LC
동원수산	OG
임곡삼거리	LC
자유무역지역	LC
석전동	LC
극동가스	OG
서마산IC	LC
플레이플	OG
5주간	DT
양경갑	PS
11/21	DT
23:59	TI
선동열	PS
이튿날	DT
최형우	PS
콜롬비아	LC
엘킨소토	PS
안재욱	PS
ENTURN	OG
김윤미	PS
동해시청	OG
김경옥	PS
철원군청	OG
베스텍씨앤씨	OG
윤아	PS
오후7시10분	TI
제춘모	PS
올봄	DT
흥국생명	OG
이번	DT
복건성	LC
낙하산	PS
문화방송	OG
민병흥	PS
03/18	DT
15:52	TI
조선	LC,OG
세조	PS
양	PS
20분	TI,DT
731부대	OG
조세소위	OG
소위	OG
올한해	DT
한바다중학교	OG
스카이라이프	OG
스카이스포츠	OG
에드윈	PS
반데사르	PS
터키	LC
장나라	PS
우시	LC
2009년4월26일	DT
9	DT
거제시	LC
자연생태테마파크	LC
농업개발원	OG
거제스포츠파크	LC
둔덕	LC
산방산	LC
치우미	OG
축구협회	OG
양준혁	PS
야곱	PS
요셉	PS
손	PS
2일(수)	DT
3일(목)	DT
서정희	PS
FOX	OG
영화인회	OG
유창서	PS
국토부	OG
문현동	LC
5년간	DT
한국거래소	OG
하림	OG
하림홀딩스	OG
마니커	OG
동우	OG
4월9일	DT
요미우리자이언츠	OG
광주광역시	LC,OG
2013	DT
한국예술종합학교	OG
황지우	PS
법원	OG
김정헌	PS
노무현	PS
김재동	PS
팀버튼	PS
조니뎁	PS
이청용	PS
안	PS
김주찬	PS
김창삼	PS
1987년	DT
애플	OG
TU미디어	OG
서울지방경찰청	OG
강남경찰서	OG
역삼지구대	OG
이대형	PS
보아	PS
농협출장소	OG
정민	PS
06/04	DT
10:26	TI
매니페스토본부	OG
60일전까지	DT
벤츠	OG
지나ㄴ2006년5월30일7월31일까지	DT
2006년10월26일부터11월30일	DT
신화통신	OG
스포츠호치	OG
하라	PS
램퍼드	PS
제라드	PS
방송위원회	OG
FC메스	OG
페루자	OG
요코하마	OG
송유걸	PS
김병지	PS
오는3월11일	DT
리오스	PS
정재훈	PS
2월1일부터	DT
삼성생명	OG
변연하	PS
북창동	LC
류시원	PS
하시모토	PS
노영심	PS
정재일	PS
지난주	DT
래리버드	PS
오후1시30분	TI
종로구	LC
견지동	LC
크리스티아누호날두	PS
웨인루니	PS
폴스콜스	PS
카를로스테베스	PS
주문진중	OG
장일주	PS
박정용	PS
김병호	PS
양재역	LC
서초구청	OG
06:40	TI
23:10	TI
오건우	PS
오세규	PS
오후6시30분	TI
춘계여자축구연맹전	OG
대교	OG
현대제철	OG
박은선	PS
서울시청	OG
원주원주	LC
동부프로미	OG
프로	OG
3주전	DT
프레드베르그스텐피터슨	PS
광주상무	OG
금속노조	OG
기아자동차지부	OG
김태영	PS
민주노조	OG
거제	LC
대만	LC
태평양	LC
김상곤	PS
심재용	PS
오륙도	LC
영도	LC
김하종	PS
김선민	PS
정조국	PS
이민성	PS
자문위	OG
ChrisBhm	PS
3년차	DT
황운	PS
6.2	DT
100여이ㄹ	DT
1주기	DT
뉴욕증권거래소	OG
NYSE	OG
나스닥	OG
오후6시36분	TI
잡스	PS
조해리	PS
고양시청	OG
김민정	PS
전북도청	OG
이은별	PS
연수여고	OG
박승희	PS
광문고	OG
2010밴쿠버	DT
동숭아트센터소극장	OG
문삼화	PS
비비안리	PS
말론브란도	PS
서울시의회	OG
지나ㄴ1일부터오는10일까지	DT
지나	DT
2006년	DT
3	LC,TI,DT
샤라포바	PS
오는1월13일	DT
서보미	PS
토레만테	PS
모쿠레스쿠	PS
영화제작가협회	OG
현주엽	PS
조상현	PS
스포츠서울프	OG
D-3	DT
제피로스골프클럽	OG
오는7월23일	DT
영생	OG
현일	OG
서울대학교	OG
오연천	PS
안철수	PS
KT중앙연구원	OG
33년간	DT
황동일	PS
김윤진	PS
나문희	PS
현대차	OG
에릭칸토나	PS
부천SK	OG
마차도	PS
미카	PS
형준	PS
기영	PS
MBC드라마넷	OG
준코	PS
순자	PS
16-17일	DT
오대석	PS
상원고	OG
조홍희	PS
서귀포평생학습센터	OG
한명숙	PS
하루전	DT
국민권익위	OG
국민	OG
60~120일이내	DT
2주이상	DT
김정권	PS
경남신문	OG
권경석	PS
한나라	OG
창원갑	PS
이영동	PS
김수곤	PS
북면	LC
김우진	PS
동읍	LC
정삼석	PS
창신대학	OG
건축디자인과	OG
조일환	PS
대산면	LC
상포마을	LC
김진규	PS
박희상	PS
조원우	PS
계양구	LC
칸	PS
호나우도	PS
금호타이어	OG
로코미디에이트	PS
주광열	PS
송	LC,PS
8년전	DT
조익희	PS
세종문화회관	OG
공평희	PS
이호준	PS
엄정화	PS
롯데칠성음료	OG
펩시콜라	OG
유한킴벌리	OG
1년이하	DT
2개월	DT
1년까지	DT
미디에이트	PS
시티	OG,PS
한세실업	OG
컬리수	OG
드림스코	OG
남산	LC
8시	TI
09시30분	TI
10시30분	TI
마쓰다	OG
푸에르토리코	LC
포클랜드	LC
1500년대	DT
1690년	DT
궈홍치	PS
로아이자	PS
유정복	PS
정몽준	PS
타오루나	PS
라나쟈스팔	PS
인도	LC
aba	OG
닌텐도	OG
탱크	PS
장윤정	PS
윤명선	PS
2008년4월	DT
경기	LC
평택	LC
당진	LC
황해경제자유구역	LC
C.호날두	PS
루니	PS
에브라	PS
스콜스	PS
실베스트르	PS
게리네빌	PS
김상우	PS
김인	PS
경남무역	OG
사천	LC
사천시청	LC
민예총	OG
구단	OG
신촌창천공원	LC
오후7시부터	TI
브런치	PS
허재	PS
공화당	OG
30분	TI
전	TI,PS
칼라	PS
BrighamYoungUniversity	OG
부산교육청	OG
PGA	OG
소노브이	OG
장원봉	PS
03일	DT
07-08	DT
로하스대학	OG
황수관	PS
삼성치어리드	OG
강대협	PS
이현승	PS
SK증권	OG
국군	OG
신치용	PS
중앙부처	OG
원주문협	OG
이무권	PS
김종호	PS
류각현	PS
고창영	PS
이승열	PS
김남연	PS
이재하	PS
3년간	DT
코나	OG
현대중	OG
푸마스	OG
전,후반	TI
레킷벤키저사	OG
이건무	PS
화성	LC
전국경제인연합회	OG
코리아소사이어티	OG
KoreaSociety	OG
전경련	OG
미국상공회의소	OG
한미재계회의	OG
현재현	PS
동양그룹	OG
윌리엄로즈	PS
씨티그룹	OG
윤상혁	PS
남	LC
매그	PS
서원밸리	OG
김두관	PS
안희정	PS
마이클펠프스	PS
이참	PS
지관	PS
지난달19일	DT
밤자정	TI
의왕경찰서	OG
경기청	OG
전투경찰대	OG
밸런타인	PS
더타임즈	OG
온미디어	OG
스토리온이	OG
밸런타인데이	DT
방파제	LC
밤	TI
동두천시	LC
이호연	PS
마이데이ㄹ리	OG
억불봉	LC
최동수	PS
박한이	PS
부산대	OG
국제전문대학원	OG
대학원	OG
부산문화방송	OG
고영립	PS
화승그룹	OG
오거돈	PS
한국해양대	OG
신라저축은행	OG
조민기	PS
요르단	LC
허정무	PS
엠게임	OG
사회복지공동모금회	OG
설연휴기간동안	DT
하이닉스반도체	OG
한국네슬레	OG
거북이	PS
한국개발연구원	OG
KDI	OG
40주년	DT
오는24일	DT
양일	DT
사천시	LC
이승화	PS
골드호	OG
24시간	TI
서울수화전문교육원	OG
1개월	DT
공동준비위	OG
차이나켐	OG
그룹	OG
니나왕	PS
차이나켐자선기금	OG
이니이나왕	OG
베드리지역	LC
브리지트바르도	PS
장뤽고다르	PS
1963년	DT
마틴스코세지	PS
플로리다	OG
롯데카드	OG
박정희	PS
김광현	PS
김주형	PS
차일목	PS
샌안토이오	PS
댈러스매버릭스	OG
뉴올리언스호네츠	OG
3분기부터	DT
4분기	DT
전분기	DT
남북정상회담	OG
오창	LC
청주흥덕경찰서	OG
지나ㄴ7일부터	DT
설명절연휴까지	DT
남해안	LC
국토해양	OG
아우디폭스바겐코리아㈜	OG
리	OG
2003년6월14일	DT
5년	DT
이선화	PS
미하일로비치	PS
30개월령	DT
0910	DT
살로몬	OG
1분28초전	TI
58．9초전	TI
번게이	PS
저스티스코에치	PS
0.3초	TI
CNBC	OG
전주시청	OG
24초06	TI
구글	OG
모토로라모빌리티	OG
5	OG,DT
대선주조	OG
세운철강컨소시엄	OG
BN그룹컨소시엄	OG
무학	LC
리닝	PS
이운재	PS
미드필드	LC
지난해11월부터	DT
경남도통합준비단	OG
오후6시까지시	TI
오는5일부터	TI
통합준비위원회자문단	OG
통합준비위원회	OG
SBS에이스	OG
지나ㄴ달29일	DT
용인	LC
로즈	PS
사흘간	DT
맨	OG
안데르손	PS
CJ제일제당	OG
10:30	TI
압구정지구	LC
제주투데이	OG
오는4일	DT
한선교	PS
오는8월말	DT
김영수	PS
4년	DT
새벽1시	TI
내달2일부터	DT
경부축	LC
선산휴게소	LC
동서울	LC
지나ㄴ4월	DT
유타	OG
지현우	PS
최석봉	PS
스키조	PS
바셀린	PS
예레미	PS
크래쉬	PS
20주년	DT
도메인	PS
디어사이드	PS
블리스	PS
2~3년간	DT
12월12일12	DT
데이비드베컴	PS
LA갤럭시	OG
MLS	OG
솔리드	PS
김조한	PS
지나ㄴ2000년	DT
앤서이니	PS
웨이드	PS
보쉬	PS
범석	PS
초저녁	TI
김영춘	PS
14분37초06	TI
한국캐피탈	OG
3월26일	DT
4월14일까지	DT
김주연	PS
강원영동병무지청	OG
김지환	PS
오는10일	DT,PS
10시부터	DT
병무청	OG
2010년도	DT
부평	LC
한달동안	DT
매주목요일	DT
북제주군	LC
애월읍	LC
어음리	LC
구좌읍	LC
덕천리	LC
2000년부터	DT
새별오름	LC
오는18일부터3월1일까지	DT
휴애리공원	LC
김영기	PS
산업은행	OG
축구공화국	OG
국방부	OG
4개년	DT
국방	OG
2012년	DT
현대터트리	OG
2002년부터지나ㄴ시즌까지	DT
지한파	DT
왈론드	PS
마이너리그	OG
김영대	PS
국민참여당	OG
이봉수	PS
경남도당	OG
김해연	PS
김한주	PS
이세종	PS
대우조선노조	OG
김영구	PS
박광수	PS
어	OG,PS
고려대	OG
한은	OG
80년대	DT
리버풀토레스를	OG
문종원	PS
최대철	PS
전수미	PS
윤길	PS
문예신	PS
브랜드	PS
브라이언하퍼	PS
인수초	OG
수원시청	OG
지난달16일	DT
계룡중학교	OG
손광모	PS
지나ㄴ13일목요일	DT
오후1시부터1시30분까지	TI
이스타항공	OG
지나ㄴ23일	DT
2007	DT
스피도	OG
비자카드	OG
공산당	OG
플레이어	PS
하나SK카드	OG
차연희	PS
전반5분	TI
전반9분	TI
안도코주에	PS
오타니미오	PS
김미정	PS
식사	LC
아우네	OG
올림픽공원	LC
이의윤	PS
어울림에ㄹ시스	OG
설진연	PS
베를린	LC,OG
스텔리안	PS
필미켈슨	PS
지나ㄴ92년	DT
충북도의회	OG
작년말	DT
이달중순	DT
광동제약	OG
제주지원	OG
농산물품질관리법	OG
올해부터	DT
송도지식산단	LC
세이프넷	OG
SafeNet	OG
크리스페데	PS
ChrisFedde	PS
김나영	PS
SH공사	OG
유민근	PS
감성킬러	PS
어니엘스	PS
액티비전	OG
코리아	OG
올림푸스	OG
국세청	OG
진로	OG
오후7시30분부터	TI
대전시	LC
은행동	LC
NSIC	OG
네바다주	LC
캘리포니아주	LC
네바다	LC
신송식품	OG
프랑코	PS
사사에겐이치로	PS
佐佐江賢一郞	PS
외무성아시아대양주	OG
하일성	PS
허운	PS
모라티	PS
세리에A	OG
주한영국문화원	OG
IDP에듀케이션	OG
이강래	PS
CT&T	OG
김치율	PS
장목면	LC
이수도	LC
오전7시	TI
옥포	LC
정민태	PS
보건당국	OG
4월부터	DT
케빈	PS
윤상현	PS
카림가르시아	PS
JDC	OG
동홍동	LC
서귀포	LC
블랙아이드피스	PS
레이디가가	PS
마릴린맨슨	PS
디라본티즈	PS
존카메론미첼	PS
50년동안	DT
근로복지공단	OG
1966	DT
년	DT
잭	PS
kntv	OG
이정희	PS
민노당	OG
지나ㄴ4일	DT
3시간이상	TI
스마일서브	OG
미란다커	PS
체육학과	OG
박종성	PS
로버트박	PS
조용형	PS
해켓	PS
브랙케트론	OG
Bracketron	OG
해군	OG
아키	PS
10여년전	DT
허민우	PS
분당	LC
인천여성노동자회	OG
김상록	PS
영상디스플레이사업부	OG
무선사업부	OG
리동규	PS
체육과학연구소	OG
남조선팀	OG
중국팀	OG
남조선	OG
박철우	PS
송강카누학교	OG
박영석	PS
일일	DT
윤진서	PS
LG트윈스	OG
김윤기	PS
미래에셋증권	OG
S&T대우	OG
연수구	LC
남무교	PS
평생교육기관	OG
주민자치센터	OG
현대카드	OG
서울시립미술관	OG
김진영	PS
쇼팽	PS
드뷔시	PS
더존비즈온	OG
김용우	PS
2011년1분기	DT
정규시즌	DT
샌안토니오스퍼스	OG
듀크에너지	OG
프로그레스에너지	OG
정의현	PS
01/15	DT
22:41	TI
서울삼성썬더스	OG
2007-08	DT
정재원	PS
1년1개월	DT
한국전력	OG
에스에프에이	OG
펠레	PS
방콕	LC
지나ㄴ1993년	DT
고등법원	OG
한국정보화진흥원화	OG
노명수	PS
2000	DT
파월	PS
오는5월	DT
임태희	PS
정책위원회	OG
장영달	PS
CNN	OG
BBC	OG
로버트게이츠	PS
적가리골	LC
이폭포	LC
저폭포	LC
공정위원회	OG
육십령	LC
라미레스	PS
진야곱	PS
존스	PS
데릭리	PS
4월12일	DT
이준형	PS
박용래	PS
국	PS
동경	LC
5월11일부터14일	DT
내달	DT
남극	LC
다음달4일부터	DT
ALEXANDRIDISAlex	PS
구간	LC
운암삼거리~구절재	LC
7시간30분	TI
유필우	PS
주안역	LC
숭의종합사회복지관	OG
오는3월	DT
문정희	PS
김태우	PS
옥주현	PS
신성구	PS
자치행정과	OG
최인기	PS
민원봉사과	OG
대한적십자사	OG
박수영	PS
박재영	PS
삼성하우젠	OG
포항제철지곡초등학교	OG
왕기춘	PS
장난감	OG
장난감월드	OG
인사동	LC
아사쿠사	LC
우에노	LC
쥬니	PS
이병헌	PS
춘해보건대학	OG
김천시	LC
기획재정위원회	OG
하동군	LC
이홍구	PS
이형선	PS
최강타	PS
태하	PS
오지호	PS
철웅	PS
이종혁	PS
마르티네스	PS
테세이라	PS
우들리	LC
지난해부터	DT
시네마테크부산	OG
지나ㄴ4.29	DT
진보신당	OG
김성환	PS
외교통상부	OG
장관	OG
한중외교장관회담	OG
유재석	PS
37년	DT
호동	PS
이경규	PS
군대	OG
헐크	PS
정동식	PS
시교육청	OG
교직복무심의위	OG
교육청	OG
징계위원회	OG
교직복무심의위원회	OG
최진한	PS
17년	DT
김원형	PS
홍성흔	PS
류제국	PS
올림픽축구대표팀	OG
대웅제약	OG
지난해말부터	DT
차두리	PS
환경과학원	OG
10월23,24일	DT
응봉산	LC
鷹峰山	LC
용소골	LC
덕풍계곡	LC
스포니치	OG
오는6월	DT
1960년대	DT
가마모토	PS
무리뉴	PS
김충용	PS
종로구청	OG
종로구장학회	OG
지훈	PS
최다니엘	PS
정음	PS
황정음	PS
TNmS	OG
로레이나오초아	PS
3주	DT
과천	LC
정부종합청사	OG
바비킴	PS
몬트리얼	LC
강릉문화예술관	OG
야간	TI
하회마을	LC
지나ㄴ2009년12월말	DT
6개월	DT
장클로드트리셰	PS
ECB	OG
이규원	PS
용인대	OG
인천상의	OG
총무기획팀	OG
부산성폭력상담소	OG
부산도시공사	OG
노무라종합연구소	OG
최흥철	PS
최용직	PS
김현기	PS
지나ㄴ1998년	DT
한국마이크로소프트	OG
김제임스우	PS
4주년	DT
12개월	DT
이달17일부터	DT
50일간	DT
라마다플라자청주호텔	OG
1월	DT
부동산	OG
부동산114	OG
이달5일	DT
서울지역	LC
지난해1월초	DT
2년차	DT
더블유한의원	OG
김우병	PS
율동콩나물	OG
K-두채	OG
콩나물	OG
와이낫?	PS
사일런트아이	OG
윤병주밴드	PS
이병덕	PS
원주시	LC
원동	LC
오는30일	DT
수원청소년문화센터	OG
송진우	PS
한화이글스	OG
전국농협중앙회	OG
중화인민공화국	LC
정민철	PS
지난해7월	DT
돈넬슨	PS
전주기계탄소기술원	OG
효성	OG
2008년부터	DT
노철래	PS
정세균	PS
자유선진당	OG
이회창	PS
이상득	PS
모건엔스버그	PS
제이슨레인	PS
스페인농구대표팀	OG
삼산	LC
제주항공	OG
나상욱	PS
코브라골프	OG
영동	LC
공진석	PS
진승	OG
무역	OG
지나ㄴ24일	DT
국제	LC
울산구단	OG
최성국	PS
가시와	OG
20	DT
빅마마말	PS
7월말부터	DT
오가사와라	PS
동산정산	OG
현대정과	OG
김명선	PS
호나우지뉴	PS
2007-08시즌	DT
바르셀로나	OG
프리메라리	OG
경남도	LC
10일부터	DT
버튼	OG
이계호	PS
원주경찰서	OG
112신고센터	OG
이소연	PS
장희빈	PS
이병훈	PS
제이씨엔터테인먼트	OG
김양신	PS
금일	DT
박진희	PS
96년이후	DT
교대	OG
교원대	OG
지나ㄴ20일	DT
이정민	PS
대원외고	OG
셸	OG
텍사코	OG
금산군청	OG
경쟁당국	OG
제리	PS
오는2014년	DT
용유도	LC
무의도	LC
김대현	PS
강지만	PS
김대섭	PS
석종율	PS
김형태	PS
최호성	PS
김상기	PS
김위중	PS
웨스트	PS
PSV에인트호벤	OG
오는3월부터	DT
파쇼나블	OG
목동	LC
파캔오피씨	OG
2008시즌	DT
허준영	PS
10일자	DT
팽정광	PS
의정부경전철㈜	OG
회장님	PS
신수지	PS
김영철	PS
김해외	OG
이정철	PS
한국대표팀	OG
백현	PS
현정	PS
지연	PS
풀잎	PS
엄	PS
김두현	PS
애쉬튼커쳐	PS
노원정보도서관	OG
우라와레즈	OG
다나카타쓰야	PS
우라와	OG
토마스	PS
이재남	PS
노원구	LC
상계10동	LC
아사다마오	PS
유니더스	OG
오는28일	DT
송파구	LC
송파여성문화회관	LC
김수경	PS
세계야생생물기금	OG
WWF	OG
2AM	PS
태웅	OG
전반4분	TI
발락	PS
후반42분	TI
박3일	DT
2009년9/26-27일~2009년12/27일	DT
올해말까지	DT
내년부터	DT
월산마을	LC
양지병원	OG
최현종	PS
세인트포골프＆리조트	OG
프레드코스	LC
지나ㄴ21일	DT
메사추세츠	LC
레베카헤인즈	PS
라스베이거스	LC
맥카란국제공항	LC
반다이남코	OG
9월	DT
10월3일	DT
이상목	PS
하나님	PS
엔씨소프트	OG
삼성동	LC
여민지	PS
정선민	PS
삼공물산	OG
춘천권	LC
하프타임	TI
평촌	LC
산본	LC
2012년12월31일까지	DT
박영부	PS
공	PS
김은희	PS
동유럽	LC
GM대우	OG
송영휘	PS
고양국민은행	OG
당원자격심사위원회이	OG
남상우	PS
전반20분	TI
서튼	PS
보료다	PS
관할지구대	OG
파출소	OG
지미카터	PS
김정일	PS
이날	DT
그랜트첼시	PS
싼토리선버즈팀	OG
LG하우시스	OG
1분기	DT
이인	PS
오는2007년12월까지	DT
2년6개월간	DT
모태범	PS
함께하는사람들	OG
메이저리그이	OG
강성천	PS
한국노총	OG
김장수	PS
배은희	PS
한국바이오벤처협회	OG
장사익	PS
고완선	PS
홍지동	LC
45일	DT
2010년4월23일	DT
박석민	PS
경찰청	OG
2군리그	OG
7월20일23일까지	DT
8월22일	DT
키코	OG
2009년3월13일	DT
젬	PS
JEM	PS
다니엘헤니	PS
왕자웨이	PS
니콜키드먼	PS
미야네	PS
지난달26일	DT
ABC-TV	OG
아침프로	PS
2007시즌	DT
윤두서	PS
1946년3월1일	DT
박경모	PS
인천계양구청	OG
김기훈	PS
02/03시즌	DT
지산리조트	OG
스노우보드학교	OG
7년	DT
오는15일	DT
보와	PS
매일	DT
LS엠트로	OG
공조시스템사업부문	OG
예수	PS
문배마을	LC
구곡폭포	LC
베니	PS
모자라나후쿠우라	PS
강릉	LC
남해동부멀ㄴ바다	LC
동해멀ㄴ바다	LC
김계관	PS
외무성	OG
박세리	PS
E2	OG
유한양행	OG
한미약품	OG
누경	PS
강주	PS
7월21일	DT
조지아주	LC
오거스타	LC
오거스타내셔널골프장	LC
SHOW	OG
정주연	PS
칠드리스	PS
토비코	OG
WNBA	OG
2000년2월이후	DT
다음해	DT
대신증권	OG
인흥초등학교	OG
은혜와진리교회	OG
PRIOR	OG
프라이어	OG
독종	PS
파이셔	PS
FC바르셀로나(스페인	OG
유럽축구연맹	OG
UEFA	OG
한국가스공사	OG
오는29일	DT
김선아	PS
TV리포트	OG
원혜영	PS
안도	LC
악셀룬스빈달	PS
아모에바	OG
네이버	OG
아이엠지	OG
예프게니키신	PS
안젤라게오르규	PS
마티아스괴르네	PS
사라장	PS
성시연	PS
서울시향	OG
용화산	LC
파로호	LC
3월21일	DT
한혜진	PS
한마음상호저축은행	OG
서동현	PS
올리비아뉴튼존	PS
멜버른	LC
1968년	DT
빅터토마스	PS
레더	PS
진주혁신도시	LC
국민연금공단	OG
한국산업기술시험원	OG
한국남동발전	OG
중앙관세분석소	OG
주택관리공단	OG
동국	OG
티아라	PS
수산나리가시	PS
길다부타	PS
탬파베이데블레이스	OG
노모히데오	PS
1979년5월	DT
제주대	OG
박성광	PS
21,22일	DT
이탈리아,	OG
폴란드,	OG
서동석	PS
29:46	TI
토요타자동차(주)	OG
다이하쯔공업(주)	OG
다이하쯔	OG
히노자동차(주)	OG
히노	OG
설화	PS
화천	LC
이수영	PS
김남석	PS
1960~70년대	DT
2008년12월	DT
서대문소방서	OG
김지석	PS
파머	PS
울산과학	OG
강원도립	OG
Thirty	OG
two	OG
06	DT
07	DT
위클리	PS
위	LC,PS
내년시즌	DT
광주신세계	OG
오전8시30분	TI
광천동	LC
광주신세계백화점	OG
트위터	OG
4월7일부터22일까지	DT
16일간	DT
제주유나이티드	OG
장준환	PS
러	LC
tvN	OG
최혜용	PS
LIG	OG
김학범	PS
부산2	OG
중앙부산	OG
보해저축은행	OG
도민저축은행	OG
이희솔	PS
루마니아	LC
부쿠레슈티	LC
유민	PS
1995년3월	DT
청촌장학재단	OG
김만수	PS
1956년	DT
건축토목과	OG
동아타이어그룹	OG
앤드리애거시	PS
나달	PS
강원경찰	OG
내달초	DT
당원협의회	OG
공심위	OG
후반31분	TI
문화일보	OG
최경환	PS
김대중평화센터	OG
싱클레어	PS
버즈	PS
6106	DT
한겨레	OG
벨기에	LC
에넹	PS
부산노동청	OG
창원지청	OG
창원원	OG
진해	LC
中	LC
씨엔블루	PS
강원사대부고	OG
황경신	PS
이성	PS
이계윤	PS
아이리버	OG
5분	TI
수완지구	LC
안경현	PS
귀네슈	PS
차범근	PS
김황식	PS
내년1월1일	DT
지우마호세피	PS
성시백	PS
오노	PS
2008년7월	DT
같은해11월	DT
홍일표	PS
차동민	PS
오방실	PS
S-Oil	OG
오성엘에스티	OG
한국실리콘	OG
아테네	LC
북경	LC
제주시	LC
아라동	LC
백악관	OG
지나ㄴ늦가을	DT
마이티마우스	PS
쇼리J	PS
천년	DT
두륜산	LC
서울우유	OG
현우	PS
CJ프리미엄TV매거진헬로tv	OG
닥터K	PS
토요	DT
일요	DT
지리산	LC
智異山	LC
삼성증권	OG
SGA	OG
내달26일	DT
한국교원단체총연합회	OG
김태술	PS
마리나	LC
오는11월	DT
제이아르	OG
JR	OG
김중현	PS
인천체고	OG
지창욱	PS
니스텔루이	PS
전반7분	TI
42분	TI
해운대구	LC
장산	LC
텐드	OG
박철순	PS
96년8월2일	DT
기술표준원	OG
소비자원	OG
플로리다말린스	OG
코데로	PS
20여년전	DT
안드레아스	PS
하이네케	PS
이용훈	PS
미녀새	PS
옐레나이신바예바	PS
러시아선수단	OG
남자농구대표팀	OG
안드레이키릴렌코	PS
울산시교육청	OG
2010학년도	DT
설렌타인데이	DT
재일본한국YMCA	OG
김수남	PS
동경한국학교	OG
어머니합창단	OG
김송이	PS
부산시	LC
반여4동	LC
전병두	PS
기술보증기금	OG
기보	OG
대아고속해운	OG
울릉군청	OG
인천강화	OG
울산학성	OG
환절기	DT
수정	PS
크	OG,PS
LA에인절스오브애너하임	OG
김석윤	PS
중순	DT
오는4월	DT
부개	LC
페테르손	PS
제네바국제공항	LC
연간	DT
2008년5월	DT
집속탄금지협약	OG
양정승	PS
손범규	PS
오ㄹ가을	DT
아수스	OG
케빈두	PS
민나온	PS
장동건	PS
3월6일	DT
고소영	PS
유성구청	OG
한국레저산업연구소	OG
서천범	PS
3분기	DT
조아람	PS
애리조나다이아몬드백스	OG
70년대	DT
한국기후변화대응연구센터	OG
오전10시30분	TI
한국기후변화포럼	OG
뤼앤지지에	PS
인디스토리	OG
정진후	PS
전국교직원노동조합	OG
하은주	PS
울산시	LC
울산산업주간	LC
10월14일~16일	DT
태화강대공원	LC
울산산업	LC
닥터케이	OG
키작은남자	OG
호나우디뉴	PS
리오넬메시	PS
마라도나	PS
정재복	PS
삼성라이온즈	OG
나주환	PS
피아퐁	PS
촌부리	OG
포드자동차	OG
볼보	OG
이원재	PS
이혜천	PS
이재우	PS
임태훈도	PS
오마르알-바시르	PS
수단	LC
생명나눔재단	OG
지나ㄴ11일	DT
수지	PS
농촌진흥청	OG
관세청	OG
국가보훈처	OG
금융위원회	OG
기획재정부	OG
소방방재청	OG
특허청	OG
1990년대이후	DT
1997	DT
동해시	LC
삼육오	OG
문영민	PS
양천구의회	OG
2월20일	DT
롯데시네마송내	OG
8월3일	DT
NHN(주)	OG
김상헌	PS
2011년2분기	DT
2008년8월	DT
카이로	LC
한국신용정보평가	OG
한국기업평가	OG
한기평	OG
금호석유화학	OG
보비	PS
신영수	PS
앤서이니김	PS
03/14	DT
22:18	TI
9월초	DT
숀루니	PS
욕지권	LC
인천경제자유구역	LC
2년동안	DT
보훈처	OG
지난해2월	DT
시우다드후아레스	LC
한다협	OG
서지혜	PS
윤상호	PS
지방의회	OG
김영삼	PS
이슬기	PS
신일	OG
군인공제회	OG
여신전문금융회사	OG
한국캐피탈㈜	OG
아사쿠라	PS
대한해운	OG
쑤이페이페이	OG
황선홍	PS
조던파머	PS
백성희	PS
자연과학대학	OG
생명과학부	OG
연건동	LC
선진7개국	OG
철원오대쌀	OG
8주	DT
최유리	PS
북원여	OG
정애리	PS
조소과	OG
스무디킹	OG
김성완	PS
2009년10월10일	DT
밤10시30분	TI
시카고불스	OG
크리스듀혼	PS
손제민	PS
중부지방	LC
서해안	LC
청주시청	OG
수암골	LC
김태환	PS
KAL호텔	OG
10월2일	DT
정덕화	PS
지난해1월	DT
올해1월	DT
고종	PS
영친	PS
英親	PS
이은	PS
李垠	PS
1897-1970	DT
이구	PS
줄리아	PS
스팔레티	PS
선	PS
남도	LC
대덕구	LC
유성구	LC
동구	LC
Nintendo	OG
하이얼	OG
Haier	OG
오앤영성형외과	OG
오영환	PS
서울대야구부	OG
일구회	OG
지난해12월	DT
2분	TI
데얀	PS
9분	TI
아야세하루카	PS
닛칸스포츠	OG
조혜정	PS
황민경	PS
세화여고	OG
KT&	OG
G	OG
대구여고	OG
김은영	PS
30년이상	DT
우리파이낸셜	OG
강수지	PS
시티오브런던경찰	OG
3일까지	DT
이유	PS
인도네시아	LC
병	OG
질병관리본부	OG
도시바	OG
정순훈	PS
배재대	OG
지나ㄴ2003년3월	DT
운악산	LC
동아시아정상회의	OG
EAS	OG
발리	LC
공군기지	OG
2004	DT
구민정	PS
앙리	PS
아스날	OG
패트릭비에이라	PS
데니스베르캄프	PS
13:00	TI
여주대학	OG
울산과학대	LC
리마	PS
박태환	PS
강원체고	OG
현지훈	PS
1분53초80	TI
6초	TI
슈퍼주니어	PS
양산시청	OG
플라이투더스카이	PS
김호준	PS
6년간	DT
신문로	LC
연세대	OG
호남대	OG
정철어학원주니어	OG
정철인터랩	OG
도요타자동차	OG
7월14~20일	DT
김문수	PS
농림수산식품	OG
이낙연	PS
내년상반기까지	DT
올시즌뒤	DT
이수만	PS
시사저널	OG
3DTV방송진흥센터	OG
라트비아	LC
벨로루	OG
김종국	PS
슈세프스키	PS
상비군	OG
가평군의회	OG
조한길	PS
가평	LC,OG
여행스케치	PS
김세영	PS
에듀윌	OG
박보영	PS
박선영	PS
신창중학교	OG
우이천	LC
한국사회복귀시설협회	OG
찰리박	PS
미셀위	PS
아니베팜프	OG
한국등산중앙연합회	OG
고든스트라천	PS
셀틱	OG
일본축구대표팀	OG
나카무라순스케	PS
태릉선수촌	LC
3월29일	DT
노수석	PS
국립의료원	OG
8월20일	DT
연세대학교	OG
야외노천극장	OG
2006년부터	DT
라오스	LC
코라오디벨로핑	OG
코라오홀딩스	OG
회담	OG
남북정상	OG
김명만	PS
한화증권	OG
푸르덴셜투자증권	OG
푸르덴셜자산운용	OG
지나ㄴ1일부터	DT
이덕재	PS
이덕건	PS
장만세	PS
13일부터	DT
아덴만의영웅	PS
석해균	PS
welfarenews	OG
오는26일부터28일까지	DT
봉성리	LC
세븐라이프	OG
구로구청	OG
2003	DT
북한대표팀	OG
달성	LC
북한서포터스(Supporters)	OG
지나ㄴ27일까지	DT
백희수	PS
연희	PS
09/10	DT
테크나인	OG
중궈베이처	OG
탄샤오펑	PS
경주시	LC
한국초등학교축구연맹	OG
㈜대교	OG
시슬리	OG
스타일러스	OG
바찌이니	OG
리골드	OG
몰리즈	OG
스와로브스키	OG
라돈치치	PS
장학영	PS
사회복지섬나기제주시니어클럽	OG
황영애	PS
오는26일까지	DT
이계진	PS
강원도당	OG
카브레라	PS
국제배구연맹	OG
FIVB	OG
사카이데오사무	PS
2007~2008	DT
화	OG
클론	PS
제주체신청	OG
올해설	DT
서울중앙지검	OG
내곡동	LC
형사1부	OG
백방준	PS
부산지방해양항만청	OG
포춘	PS
한성컴퓨터	OG
한동렬	PS
울트론	OG
ULTRON	OG
서동철	PS
지펠	OG
박스오피스	OG
심대평	PS
70~80년대	DT
1박2일	DT
범계역1	LC
06시30분	TI
인덕원역	LC
06시35분	TI
사당역3	LC
07시	TI
서초구민회관주차장	LC
07시20분	TI
복정역1	LC
07시40분	TI
죽전	LC
신갈	LC
07시45분	TI
3달	DT
문형선	PS
05/11	DT
11:52	DT
홍천	LC
홍천이두FC	OG
강릉시청	LC,OG
진갑용	PS
가마가츠	OG
동부지구	OG
서부지구	OG
한국영화제작가협회	OG
매니지먼트협회	OG
해	LC,DT
모로코	LC
라경민	PS
손학규	PS
백남준	PS
그린스튜디오	OG
백남준미술관	OG
라이온즈	OG
VfB	OG
경기중앙지방변호사회	OG
장성근	PS
수도권지역	LC
경기도지역	LC
합의부	OG
서울고등법원	OG
대전고등법원	OG
현대모비스	OG
대	OG
왼발의마법사	PS
라이언긱스	PS
드림위즈	OG
dreamwiz.com	OG
맥스MP3	OG
인라이브	OG
영남알프스	LC
VNPT	OG
심상정	PS
반환미군기지	OG
경기도립대학	LC
북부지역	LC
STX중공업	OG
이라크	LC
산업광물부	OG
SCIS	OG
김동연	PS
대학로	LC
예술극장	OG
3월7일까지	DT
이민정	PS
정경호	PS
안시현	PS
아이린조	PS
정지민	PS
남자A조	OG
한양대	OG
한국농구연맹	OG
2008~2009	DT
용산구	LC
한남동	LC
다음주	DT
2주후	DT
쎄비	PS
1년후	DT
FC도쿄	OG
오후2시30분-3시까지	TI
30분간	TI
돈트렐윌리스	PS
게임하이	OG
저우싱츠	PS
수원삼성	OG
알아인	OG
UAE	LC
보니타	PS
대한민국학술원	OG
김상주	PS
2011년10월21일	DT
프린스캐피탈	OG
태자자본관리유한공사	OG
금융시장	LC
삼성SDS	OG
미라콤아이앤씨	OG
백원인	PS
문흥남	PS
신승훈	PS
오리콘	OG
피쉬&그릴	OG
지나ㄴ2월이후	DT
로드니	PS
라챗	PS
배한성	PS
팬더	PS
영화제사무국	OG
스폰지밴드	PS
노르웨이	LC
보코	PS
초겨울	DT
제주축협	OG
고성남	PS
농협중앙회	OG
레알	OG
청라	LC
20:48:43	TI
상인대학	OG
전문대학원	OG
일반대학원	OG
서산	LC
예산	LC
홍성	LC
부여	LC
공주	LC
아산	LC
광역상수도	LC
풍납취수장	LC
오주상사	OG
영업2팀	OG
오승환	PS
MBC라디오	OG
MBC방송사	OG
임병헌	PS
봉덕2동	LC
미군부대	OG
북한팀	OG
북부산림청	OG
봄철	DT
원더랜드	LC
지나1975년6월	DT
25주년	DT
1996년부터	DT
2000년이후	DT
김영갑갤러리	OG
판교	LC
강순원	PS
빠르ㄴ발	PS
장미	PS
유인영	PS
정선경	PS
시니어대표팀	OG
아리타요시후	PS
有田芳生	PS
요코타	PS
橫田	PS
메구미	PS
지나ㄴ2008년11월이전	DT
SKC	OG
에보닉	OG
EvonikDegussaGmbH	OG
한국이	LC
EDPK	OG
EvonikDegussaPeroxideKorea	OG
에보닉데구사페록사이드코리아	OG
카우치	PS
남부지방법원	OG
신동주	PS
9월1일부터	DT
영등위	OG
서세원	PS
조윤희	PS
이동만	PS
경북대	OG
경상대학	OG
경영학부	OG
소리아노	PS
마쓰이가즈오	PS
미겔카이로	PS
말론앤더슨	PS
텍사스	OG
비너스윌리엄스	PS
카타르	LC
도하	LC
WTA	OG
엘레나디멘티에바	PS
보로	OG
로레아오초아	PS
고어	OG
지나ㄴ3월말	DT
닉나이트	PS
헥사바이구호	OG
오산	LC
민수	PS
김유미	PS
유진	PS
이태성	PS
기욱	PS
이민우	PS
선진당	OG
다음달말까지	DT
LS	OG
가온전선	OG
더타임스	OG
여름철	DT
지드래곤은	PS
8일부터	DT
제3폭포	LC
주방천	LC
학소대	LC
신선대	LC
시루봉	LC
관음봉	LC
촛대봉	LC
연화굴	LC
주왕굴	LC
무장굴	LC
폭포	LC
주왕암	LC
정영석	PS
세븐일레븐	OG
바이더웨이	OG
코카콜라	OG
남유럽	LC
원도보이	PS
마이클	PS
오언	PS
검단산단	LC
오는2011년이후	DT
광주태평극장	OG
고영민	PS
은정	PS
2월말	DT
최준석	PS
오재원	PS
재판부	OG
금보라	PS
지나ㄴ7월	DT
김유택	PS
오세근	PS
구채구	LC
신선지	LC
황룡	LC
단운협	LC
송판	LC
2.5일	DT
이도해	LC
누얼까이초원	LC
초원	LC
여행	LC
편도	LC
백둔리	LC
야간돌봄전담유치원	OG
코엔텍	OG
워렌버핏	PS
지나ㄴ3년간	DT
퍼시픽지구	LC
피닉스선즈	OG
행정부	OG
지나ㄴ11일이후	DT
석명준	PS
이중원	PS
4년간	DT
김기만	PS
김종학	PS
김병철	PS
이현준	PS
오용준	PS
이창수	PS
1년간	DT
강우형	PS
변청운	PS
김진호	PS
임영훈	PS
심재학	PS
근로자종합복지관	OG
지난해12월26일	DT
교과부	OG
캐디피	OG
3분18초전	TI
월남	LC
그레엄마틴	PS
포트사이트메모리얼병원	OG
케빈그리보우스키	PS
제임스볼드윈	PS
더크로스	PS
THECROSS	PS
이시하	PS
김경현	PS
배영수	PS
1928년	DT
창원	LC
마산고	OG
조선대	OG
법학과	OG
임나연	PS
중국학과	OG
밥보	OG
Babbo	OG
컨티넨탈	OG
내이ㄹ	DT
알렉스라미레스	PS
07:45	TI
잠실지구	LC
잠실대교남단주차장	LC
신상훈	PS
신한금융지주	OG
라응찬	PS
신한금융지주회사	OG
알바몬	OG
지난해1월부터오ㄹ1월까지	DT
박성효	PS
한국폴리텍대학	OG
세발자전거	PS
자탄풍	PS
나무자전거	PS
노조	OG
이충헌	PS
초롱이	PS
육민관고	OG
엘비스	PS
호남지역	LC
익산지방국토관리청	OG
전북지역	LC
마린보이	PS
인천국제공항	LC
와인하우스	PS
저탄소녹색성장비전체험관	OG
지나ㄴ4월5일	DT
대정부	OG
후앙하이양	PS
1955년부터	DT
송중기	PS
오후6시	TI
11시30분까지	TI
댄	PS
애너하임덕스	OG
캐롤라이나허리케인스	OG
탬파베이라이트닝	OG
문암1리	LC
시스코	OG
스탠리큐브릭	PS
가솔	PS
김효석	PS
방글라데시	LC
홍콩우정청	OG
우정사업정보센터	OG
사재혁	PS
한국체대	OG
조페공사	OG
전상균	PS
김광훈	PS
듀발	PS
커세어	OG
CORSAIR	OG
이노베이션티뮤	OG
검증위원회	OG
원주동부프로미	LC,OG
-	DT
여오현	PS
석진욱	PS
손재홍	PS
지나ㄴ달28일	DT
한화건설	OG
오는26일부터	DT
1997년부터2005년까지	DT
김장훈	PS
전영미	PS
전원주	PS
30일부터	DT
4주간	DT
스케쳐스	OG
조선내화	OG
광양시	LC
중동근로자복지회관	OG
김명철	PS
35:43	TI
한국남자대학대표팀	OG
장노순	PS
강원대	OG
도청	OG
춘천시	LC
김현철	PS
아마존	LC
이석우	PS
아야모리에	OG
통일부	OG
현빈	PS
팬팁닷컴	OG
인천도시개발공사	OG
오는5일	DT
오후2시	TI
하버파크호텔	OG
인천지역건설	OG
2006년9월14일	DT
한진택배	OG
한진몰	OG
로빈슨	PS
제이슨	PS
추승균	PS
교보증권	OG
황빈아	PS
24일부터	DT
벤버냉키연준	PS
마산기상대	OG
경남지방	LC
오후부터	TI
대부	OG
수도전공	OG
ATOMIC	OG
I-MATIC	OG
웅진씽크빅	OG
지난해11월2일	DT
지나9일	DT
김정문알로에	OG
추석	DT
윤진	PS
신한캐피탈	OG
나우콤	OG
문경	LC
흙벗농원	OG
린지라이트	PS
김나우	PS
충남권	LC
조명사업부	OG
키르기스스탄공화국	LC
카돌릭중앙의료원	OG
오는12일	DT
신설동	LC
프로바이오닉	OG
J-리그	OG
한국문화복지협의회	OG
코모도호텔	OG
김대연	PS
문용식	PS
공영준	PS
2002년3월12일	DT
김운용	PS
5월29일	DT
이연택	PS
40초전	TI
오덤	PS
가와모토겐조	PS
요코하마고교	OG
지나ㄴ5월16일	DT
92	DT
15일동안	DT
지나ㄴ30일	DT
롯데제과	OG
칭다오	LC
금호식품	OG
벨로루시	LC
신림	LC
홍대	OG
서귀포시선관위	OG
호비뉴	PS
마산시	LC
양덕동	LC
내서읍	LC
마산종합운동장	LC
이종열	PS
2006	DT
파헤이라	PS
곽윤기	PS
클레망틴	PS
발라크	PS
8개월	DT
노승열	PS
한국관광공사	OG
2010-2012	DT
한국관광	OG
아베신노스케	PS
아랍에미리트	LC
알자지라	OG
필립코퀴	PS
MultimediaAccelerationEngine	OG
디아	PS
축구황제	PS
제2의	PS
산토스	OG
꿈이있는자유	PS
공립학교	OG
홍정욱	PS
상계동	LC
질스튜어트	PS
이진영	PS
18	DT
이승학	PS
19	DT
낙원동	LC
서울아트시네마	LC
구허리우드극장	OG
7월7일	DT
삼척	LC
최동열	PS
팀하리칼라	PS
Pow	OG
스톤헨지주얼리	OG
오사마빈라덴	PS
안와르알-올라키	PS
예멘	LC
11년전	DT
금비	PS
금년상반기	DT
27년째	DT
27년간	DT
최상호	PS
필라델피아세븐티식서스	OG
10초	TI
국내시장	LC
민기원	PS
볼보그룹	OG
2003년8월부터	DT
볼보트럭코리아	OG
민병관	PS
7월1일부	DT
동펑닛산디젤자동차	OG
케냐	LC
남서울CC	OG
7개월	DT
지나9월	DT
한마음저축은행	OG
배스킨라빈스	OG
원더걸스	PS
17일부터	DT
나흘간	DT
영종도	LC
스카이72골프클럽	OG
72	OG
파세코	OG
2010년9월	DT
크벨	PS
유도훈	PS
KB국민은행	OG
부동산연구소	OG
1주일	DT
임	PS
Dan	PS
이라	PS
7월6일	DT
워싱턴위저즈	OG
포지	PS
니키호프스	PS
페얘노르트	OG
후반중반	TI
후반29분	TI
바히아	PS
데구즈만	PS
지나ㄴ2009년말	DT
닛산	OG
작년3분기	DT
양구	LC
우리은행	OG
동이사람들	OG
FNC뮤직	OG
오는20일	DT
코엑스	OG
인터컨티넨탈호텔	OG
이상원	PS
규민이	PS
루더밴드로스	PS
LutherVandross	PS
CBS	OG
AP	OG
AFP	OG
안영옥	PS
함안사랑회	OG
이번설	DT
가을	DT
오태현	PS
서구보건소	OG
월,수,	DT
오전10시부터12시까지	TI
2시간동안	TI
SPAC	OG
축구대표팀	OG
박남규	PS
소백	LC
동티모르	LC
김대승	PS
엘앤씨피	OG
더원시앤시	OG
경기위원회	OG
이춘표	PS
발트해	LC
이종욱	PS
맥그래디	PS
친이명박계	OG
뉴트로지나	OG
1초	TI
훼이셜	OG
양희동프로바이크	OG
벡스코바이크	OG
유소년국가대표팀	OG
2005년부터2007년까지	DT
ICE	OG
송민영	PS
USGA	OG
지나ㄴ1988년	DT
펄신	PS
한국감정원	OG
09:20	TI
티파니나	PS
자작나무숲	OG
비아이이엠티	OG
아산시	LC
음봉면	LC
소동리	LC
알래스카	LC
김상덕	PS
오뚜기	OG
이강훈	PS
앤드류바이넘	PS
4개월	DT
코마츠	OG
캐터필라	OG
달맞이	OG
아큐브	OG
천주교	OG
주교회의	OG
낙동강	LC
영통구	LC
용산	LC
2월22일	DT
아동성폭력추방의날	DT
니나	PS
학생	OG
미네소타	OG
김윤옥	PS
일리노이주	LC
시카고	LC,OG
오헤어국제공항	LC
10월24일	DT
천황재약산	LC
배네고개	LC
밀양	LC
스캇	OG
평택역	LC
홍상삼	PS
불교방송	OG
이주실	PS
전주지법	OG
진현민	PS
김형근	PS
소속사	OG
싸이	PS
07:45~08:00	TI
재경부	OG
산림청	OG
지나ㄴ1년동안	DT
윤혁	PS
최유라	PS
샌디에이고	OG
여성듀오	PS
이대이나오ㄴ여자	PS
오예리	PS
서아현	PS
이화여대	OG
리버풀	OG
베니테즈	PS
배성길	PS
명서초등학교	OG
김형실	PS
서너시간	TI
에스케이브로드밴드	OG
노현정	PS
이호석	PS
쇼트트랙대표팀	OG
10시간	TI
은재	PS
일요당일	DT
한강기맥	LC
클림	PS
한림화	PS
한국작가회의제주도지회	OG
제주작가회의	OG
홍준표	PS
염동열	PS
한국프랜차이즈협회	OG
강혁	PS
이정석	PS
일산시	LC
덕양구	LC
박창진	PS
예산정책처	OG
카이스트	OG
웅진	OG
강북	LC
데이브로버츠	PS
데미언잭슨	PS
산타나	PS
IOC	OG
김진희	PS
수원지법	OG
제3형사부	OG
박상훈	PS
김부선	PS
김근희	PS
전북현대	OG
대구FC	OG
UTV	OG
농협하나로마트	OG
양재점	OG
이명우	PS
신영	PS
다정	PS
부기	PS
김석동	PS
한국예탁결제원	OG
김경동	PS
우리금융지주	OG
오는7일부	DT
헌법재판소	OG
중도	LC
부스러기사랑나눔회	OG
구리시	LC
식품의약품안전청	OG
내년시즌이	DT
고충남	PS
대한골프협회	OG
동아대	OG
국제올림픽위원회	OG
정우람	PS
인테르밀란	OG
윤봉우	PS
임시형	PS
네오위즈게임즈	OG
최관호	PS
2002년9월	DT
시미즈S-펄스	OG
시청사잔디광장	LC
오후8시30분	TI
권영찬	PS
탬파베이	OG
피넬라	PS
지나ㄴ1년4개월간	DT
다음달부터	DT
중앙대연기예술원	OG
체코	LC
모따	PS
박진섭	PS
엔트리브소프트	OG
분데스리가프리드리히샤펜	OG
나이키	OG
조브라이언트	PS
지앤디윈텍	OG
다음달1일	DT
후쿠도메고스케	PS
2007-08정규시즌	DT
세계일보	OG
세계닷컴	OG
한국통신	OG
통신위원회	OG
봄	DT
명동	LC
지난달25일	DT
오는3월말	DT
마리온바르톨리	PS
카펠	PS
생드니	LC
프랑스AA	LC
보스니아	LC
만사마	PS
정만호	PS
김도훈	PS
전반10분	TI
2002년	DT
국가대표팀	OG
포르투갈	LC,OG
팀스콜라리	OG
무삼파	PS
파나소닉	OG
22일자	DT
제주화력	LC
김기웅	PS
인천화력본부	OG
샤모니	OG
틴	OG
기무사령부	OG
공안1부	OG
스포츠닛폰	OG
산케이스포츠	OG
김미자	PS
7월18일	DT
8월31일	DT
넥슨	OG
그라비티	OG
엔씨	OG
이니텍	OG
김중태	PS
강릉시	LC
정동진	LC
인제	LC
권재혁	PS
김민석	PS
우근민	PS
알앤디클럽	OG
영도시큐리티	OG
김한유	PS
그린둔덕	LC
해리슨포드	PS
톨	OG
찰리위	PS
천주교주교회의	OG
대한불교조계종	OG
10시	TI
내무반	OG
탕빈옌	PS
2005-04-27	DT
17:00까지	TI
류	PS
백진희	PS
소지섭	PS
휴스턴	OG
임진강	LC
태종대	LC
김한윤	PS
메켈로	PS
신용평가	OG
21년전	DT
현대로지엠	OG
현대삼호중공업	OG
모라토리엄	PS
두바이	LC
두바이월드	OG
인절스	OG
존래키	PS
세명전기	OG
대호에이엘	OG
김광호	PS
박세호	PS
이한구	PS
황명석	PS
03/11	DT
01:13	TI
김해	LC
경기초지	OG
서울가락	OG
부산부경	OG
서울경신	OG
경기과천	OG
강원원주공업	OG
경기진영정공	OG
인천운봉공	OG
경남거제	OG
경기수원공	OG
서울서울체	OG
강원묵호	OG
경남마산공	OG
강원문성	OG
서	PS
서울동물원	LC
15일까지	DT
서울대공원	LC
이지영	PS
메이저	OG
안동	LC
동부초	OG
속초중앙초	OG
이종안	PS
춘천동부초	OG
김재현	PS
클리블랜드인디언스	OG
MLB	OG
보스턴레드삭스	OG
쌍용정보통신	OG
이윤호	PS
강남구	LC
개포동	LC
대치동	LC
홍천군	LC
이종민	PS
샤프	OG
월스트리트저널	OG
김유정	PS
필리핀	LC
이정재	PS
오는2012년	DT
2012	DT
北	LC
연변축구팀	OG
지성	PS
이하자	PS
양구여중	OG
대암중	OG
애덤스콧	PS
멕시칸리그	OG
노모이	PS
최진	PS
25:23	TI
500年	DT
최만식	PS
김혜수	PS
진해시	LC
창원시	LC
수원애경백화점	OG
프랑스축구아카데미	OG
강진욱	PS
배구협회	OG
블로그칵테일	OG
이상권	PS
박희영	PS
1년뒤	DT
벤큐	OG
도립미술관	OG
연장전	TI
배익현	PS
한국경영자총협회	OG
이매진	OG
IMAGINE	OG
20일까지	DT
1980년부터	DT
지나ㄴ22일	DT
제주지법	OG
형사부	OG
박재현	PS
공단	OG
이주호	PS
교육과학기술부	OG
군산시	LC
타타대우상용차	OG
게리	PS
10월7일	DT
정일재	PS
한국표준협회	OG
영화인	OG
알베르토질라르디노	PS
파르마	OG
AC밀란	OG
장안구	LC
테베즈	PS
미야자와리에	PS
울산모비스	OG
브라이언트던스턴	PS
대구오리온스	OG
가넷톰슨	PS
서한규	PS
전준호	PS
제천	LC
청풍	LC
이옥희	PS
ockhee	PS
판도라행성	LC
잭슨	PS
오는31일부터	DT
한국콘텐츠진흥원	OG
공영화	PS
월정사종무소단기출가학교	OG
2008년5월21일	DT
수요일	DT
홍천이두FC성남일화	OG
대전한국수력원자원	OG
창원시청	OG
부산교통공사	OG
경남FC	OG
안산할렐루야	OG
인천유나이티드	OG
예산FC	OG
상무노원	OG
험멜	OG
블루윙즈	OG
고려대학교	OG
시티즌	OG
수원시청호남대	OG
미포조선	OG
유인촌	PS
김규문	PS
예비군	OG
마이크타이슨	PS
한승동	PS
구준엽	PS
지난달22일	DT
이준영	PS
삼성서울병원	OG
(주)다이소아성산업	OG
김보일	PS
김경아	PS
2010년2월16일	DT
한국금융	OG
1~3년	DT
4~6년	DT
7~10년	DT
H.I.T	PS
강타	PS
문희준	PS
토니안	PS
이재원	PS
장우혁	PS
.	PS
정운천	PS
에관공	OG
2005년1월2006년7월까지	DT
구로	LC
셔독닷컴	OG
레드데빌	OG
UFC	OG
외규장각	OG
최홍만	PS
포드	OG
미시간주	LC
T.B	PS
B.B	PS
토드바크먼	PS
대동천	LC
유씨비	OG
산성마을	LC
장유	PS
깨바즐낚	PS
518	DT
80년	DT
내무부	OG
호남정맥	LC
영진위	OG
시민영상문화기구	OG
며칠	DT
6일부터12일까지	DT
파나소닉팬더즈	OG
2007-2008	DT
싼토리썬버즈	OG
사카이블래이저	LC
강원도선수단	OG
안동섭	PS
이시지마	PS
고시카와유	PS
4강PO	OG
상이관리소	OG
가메봉	LC
억새밭	LC
산정호수	LC
퀴니	PS
행크	PS
이순철	PS
상주시	LC
루이스	PS
박인비	PS
알프레드손	PS
건우	PS
소희	PS
다우케미털	OG
바이엘	OG
바스프	OG
4월29일	DT
연이틀	DT
박연경	PS
리즈틸버리스	PS
토니자	PS
AGB닐슨미디어리서치	OG
기	DT
잠진도	LC
무위도선착장	LC
국사봉	LC
호룡곡산	LC
천국의계단	LC
촬영장	LC
하나개	LC
해수욕장	LC
무위	LC
선착장	LC
2시간30분	TI
서인천	LC
4시간30분	TI
빌바오	LC
구겐하임미술관	OG
20세기	DT
강희락	PS
한라산	LC
오는20일부터	DT
이틀간	DT
베토벤	PS
토니클락	PS
제이	PS
카니	PS
의회	OG
11:20	TI
1929년11월3일	DT
왕멍	PS
여상규	PS
172분	TI
성동구	LC
금호11구역	LC
워홀	PS
96년까지	DT
오후6시50분	TI
7시50분	TI
토니모리	OG
11월14-15일	DT
바랑산	LC
1983-84시즌	DT
오리역	LC
수원역	LC
19시간	TI
현대HCN	OG
광주인화학교	OG
스포츠바우처	OG
아주대병원	OG
부산역	LC
연합군	OG
12일어슬레틱스전	DT
220	DT
부산은행	OG
이와타	OG
맷랜들	PS
캔자스대	OG
오리온스	OG
오후8시55분	TI
9월넷째주	DT
9월26일~30일	DT
일양약품	OG
경북상호저축은행	OG
온세칼다스	OG
올림피크리옹	OG
19시	TI
SBS스포츠	OG
PSB	OG
회사	OG
원전사업수행회사	OG
SPV	OG
3분후	TI
존오셔	PS
오언하그리브스	PS
과천시	LC
지난해11월11일	DT
양평	LC
정동균	PS
유림엔마텍	OG
서부권	LC
엑스칼리버	OG
우리투자증권	OG
엔티피아	OG
문화체육관광방송통신위원회	OG
조윌프리드총가	PS
서경석	PS
제니퍼베리	PS
이틀동안	DT
정광수	PS
또랄레스	PS
파라과이	LC
산림협력위원회회의	OG
무실	LC
만종	LC
경기고	OG
스톡홀름	LC
퇴계동	LC
2009년시즌	DT
구본무	PS
26일부터	DT
모나리자	PS
고흐	PS
반기문	PS
린파스코에	PS
오는9일	DT
코코크리스프	PS
루고	PS
캐시	PS
신라에스지	OG
내달11일	DT
석촌동	LC
정수정	PS
2월9일	DT
2NE1	DT
일제시대	DT
양력설	DT
음력설	DT
조인성	PS
제닉	OG
골프황제	PS
3주후	DT
지나ㄴ26일	DT
군산세무서	OG
신당	OG
황해	LC
랜돌프	PS
지난해6월부터	DT
이마트	OG
성바오로수녀회	OG
다문화가정센터	OG
2월1주	DT
가와카미	PS
하나로	OG
KT그룹	OG
LG통신	OG
오세훈	PS
모세	PS
남부	OG
오상은	PS
서현덕	PS
탁신	PS
오는11월부터	DT
아인트호벤	OG
30	DT
2006~2007시즌	DT
비테세	OG
황인평	PS
Mnet	OG
박해진	PS
경기신보	OG
첫째날	DT
IB스포츠	OG
오는12월25일	DT
목동아이스링크	LC
윤옥희	PS
예천군청발리바	OG
이스테이트	LC
박성현전북도청	PS
모스피넥	PS
네마냐비디치	PS
2005년부터	DT
2014년까지	DT
이내주	PS
중앙노동위원회	OG
전진	PS
서영희	PS
한국남자농구대표팀	OG
영등포경찰서	OG
이태원	LC
양천구	LC
일라이릴리	OG
릴리	OG
나혜원	PS
양효진	PS
오봉옥	PS
낙동정맥	LC
애미랑재	LC
검마산휴양림	LC
사랑초교	OG
옥녀봉	LC
향봉	LC
가마봉	LC
톱바위	LC
대항	LC
3시간	TI,DT
나카타히데토시	PS
피오렌티나	OG
강릉MBC	OG
이영철	PS
세르히오가르시아	PS
폰테베드라비치	LC
소그래스TPC스타디움코스	LC
폴고이도스	PS
2008년10월18일(토)	DT
남한산성유원지	LC
카를로스딕슨	PS
유엔젤	OG
성남시	LC
이성욱	PS
보수당	OG
나가노	LC
다니엘스	PS
한농연	OG
이승은	PS
지나ㄴ1분기	DT
호주축구협회	OG
파렐	PS
문화부	OG
마포구	LC
하중동	LC
밤섬	LC
마포	LC
동	LC
한국전자정보통신산업진흥회	OG
북동부	LC
한양여대	OG
김수연	PS
1분뒤	TI
전가을	PS
송천떡마을	LC
운영위원회	OG
새해	DT
배용준	PS
허진호	PS
블루스톰	OG
돈내코코스	LC
오전10시30분부터	TI
정희철	PS
축협	OG
서울팀	OG
미르	PS
주연	PS
1일째	DT
HFS	OG
야쿠르트	OG
박미선	PS
오는2월25일	DT
더에이미	OG
문인협	PS
홍진주	PS
영상위원회	OG
천시빌럽스	PS
셉하인스	PS
허칭스	PS
애리조나	OG
백지연	PS
만안구청	OG
금년	DT
페르박	PS
성지루	PS
한국문화예술위원회	OG
오광수	PS
ARKO	OG
이달1일부터	DT
김택진	PS
윤석민자책	PS
2월3일	DT
세계보건기구	OG
WHO	OG
마가렛채ㄴ	PS
게이츠	PS
크리스영	PS
한국무역위원회	OG
LG이노텍	OG
오스람	OG
대보름	DT
20여년째	DT
다람살라	LC
현대청운	OG
경포여	OG
후반30분	TI
졸탄게라	PS
C.C.사바시아	PS
라이너스의담요	PS
3년전	DT
뮌헨	LC,OG
헤타페	OG
마이크로스트레티지코리아	OG
이혁구	PS
10월20일	DT
그랜드	OG
마이크로스트레티지	OG
퍼디낸드	PS
설날	DT
한양여	OG
여주	LC,OG
영진전문	OG
위덕	OG
니콜라스케이지	PS
원종희	PS
럭스	PS
몇주전부터	DT
상현이형	PS
정규	DT
류현진	PS
패션디자이너협회	OG
이여상	PS
최원호	PS
웨스트햄	OG
츄딘	PS
오릭스버팔로스	OG
盧武鉉	PS
지현정	PS
이인숙	PS
대한빙상경기연맹	OG
인천공항	LC
12.2~5	DT
핀란드	LC
헬싱키	LC
두물머리	LC
25년째	DT
노태환	PS
서규용	PS
농림수산식품부	OG
궁내동IC	LC
23일부터	DT
3년동안	DT
김영	PS
페어몬트턴베리아일골프장	OG
셋째날	DT
여제	PS
1시간30분	TI
AEHI	OG
AlternateEnergyHoldings	OG
돈글리스피	PS
박정권	PS
릭구톰슨	PS
고영구	PS
알파이외잘란	PS
문제헌	PS
강원본부	OG
금융안정분석국	OG
비은행분석반	OG
다음달12일	DT
유고슬라비아	LC
김명희	PS
4분00초222	TI
윔블던	LC
나흘	DT
평창군	LC
지난해까지	DT
강우석	PS
문소리	PS
당진군	LC
고대면	LC
당진포리	LC
전혜빈	PS
여혜진	PS
문화연대	OG
강병근	PS
김민영	PS
참여연대	OG
김원태	PS
서울특별시의회	OG
김형준	PS
명지대	OG
이규연	PS
중앙일보	OG
방송본부	OG
조명래	PS
단국대	OG
광화문광장	LC
강석주	PS
장외룡	PS
계양전기	OG
케이먼	PS
8월1일~5일	DT
주간	DT
두산중공업	OG
덕산하이메탈	OG
빅터	PS
율리아노	PS
근화제약	OG
이민혁	PS
곽	PS
최태욱	PS
우리히어로즈	OG
새일센터	OG
지나ㄴ1월4일1	DT
두암	PS
시장단	OG
페레스	PS
이스라엘	LC
모하메드	PS
서호프	PS
파사노	PS
광나루역	LC
동부증권	OG
소니	OG
박동혁	PS
남익경	PS
권오현	PS
삼성전자디바이스솔루션	OG
DS	OG
오는4~7일까지	DT
4일간	DT
inFILMenza	OG
Influenza+Film	OG
KT&amp;G	OG
장윤주	PS
데니스훌튼	PS
라스코리니코프	PS
고종수	PS
2005년1월	DT
선거전담반	OG
킨	PS
몇년간	DT
6월2일	DT
LG생활건강	OG
해태음료	OG
변병주	PS
오는4월14일~21일	DT
5월12일~30일	DT
중앙여고	OG
한일전산여고	OG
4주일동안	DT
지나ㄴ5월26일	DT
서구청	OG
송천권	PS
남철원	LC
이인영	PS
김신호	PS
황진원	PS
FBI	OG
음베키	PS
제프보리스	PS
강화읍	LC
남산리	LC
강화토산품판매장	OG
강화	LC
풍물시장	LC
오는3월초	DT
지나ㄴ6월11일(토)	DT
경남지부	OG
13일까지	DT
김규리	PS
지나ㄴ2008년5월	DT
장혁	PS
92년	DT
96년	DT
장가계	LC
NGO	OG
한진	OG
남서울골프장	OG
3시즌	DT
거스히딩크	PS
SK텔레콤의	OG
안드로보이	PS
토튼햄	OG
태웅이	PS
병철	PS
후반39분	TI
6.15정상회담	OG
김일성대학	OG
연경	PS
반	OG
심화반	OG
장학회	OG
지나ㄴ1994년	DT
김영란	PS
인천동구청	OG
두미트루	PS
84	DT
88년	DT
86년	DT
고구려	LC
5,000년	DT
2,	DT
000년	DT
뉴질랜드	LC
송도관광단지	LC
20:21:47	TI
20:20:59	TI
송영길	PS
20:19:54	TI
20:19:36	TI
20:18:46	TI
워싱턴내셔널스	OG
10시5분	TI
락앤락	OG
축령산	LC
유가증권시장	OG
이틀째	DT
하이서울뉴스	OG
조선기	PS
김형성	PS
멸종위기종복원센터	OG
송동주	PS
대구은행	OG
08년	DT
안기한	PS
지나ㄴ85년	DT
더그클락	PS
브래드토마스	PS
삼정회계법인	OG
박성래	PS
채드과	PS
바트브라이언트	PS
화이트데이	DT
삼성중공업	OG
삼성물산	OG
오는7월	DT
아모레퍼시픽	OG
오는8일	DT
오ㄹ상반기	DT
신한동	PS
박용호	PS
고명진	PS
아디	PS
25년간	DT
동아대병원	OG
류마티스	OG
퇴행성관절센터	OG
공주시	LC
계룡면	LC
월암리	LC
카짐	PS
리차즈	PS
P.일한	PS
B.알리	PS
C.야신	PS
5월27일	DT
NHK	OG
모리하시	PS
아시아문화전당	OG
교동초	OG
구성고	OG
신세계백화점	OG
남양주캠퍼스	LC
권용관	PS
마리아요르트	PS
제이데이비스	PS
속초해경	OG
카를로스	PS
로드리게스	PS
문광위	OG
해군사령부	OG
덕수이씨종친회	OG
이순신연구회	OG
이순신	PS
작년추석	DT
지나ㄴ4-5월	DT
필름포럼	OG
허리우드극장	OG
플로렌에밀리오시리	PS
2008년11월	DT
14개월	DT
문자	PS
에드밀손	PS
프로축구연맹	OG
8월하순	DT
김재박	PS
주예나	PS
나훈아	PS
서귀포지점	OG
백경훤	PS
성요셉요양원	OG
위미에덴요양원	OG
제주지역센터	OG
한재현	PS
허태열	PS
1938년	DT
스포츠토토	OG
캠벨	PS
4일까지	DT
이용준	PS
한미동맹	OG
주한미군	OG
FTA	OG
국립원예특작과학원	OG
최영훈	PS
다음달19-24일	DT
덕양어울림누리	OG
롯데시네마일산14	OG
일산호수공원	OG
토런리안	PS
3이	DT
김이섭	PS
2005년7월	DT
서울남부지법	OG
10개월	DT
20분14초	TI
TFG	OG
오후8시	TI
수원야외음악당잔디마당	LC
앤디워홀	PS
노라존스	PS
지나ㄴ2007년2월	DT
미투데이	OG
도교육청	OG
SKC&C	OG
통영RCE	OG
시민교육분과	OG
RCE자연생태공원부지를	LC
최동원	PS
박보생	PS
김천	LC
2주	DT
봉화군	LC
도양궁협회	OG
20일부터27일까지	DT
짐릴랜드	PS
SK네트웍스	OG
자동차유통시장	LC
메사츄세츠대학	OG
하버드대학	OG
오용원	PS
지나ㄴ6월	DT
가디언	OG
BUYSEnils	PS
라이우제강	OG
3.1절	DT
남포동	LC
자갈치시장	LC
영등포	LC
지나ㄴ9일부터12일까지	DT
E-TRIBE	PS
ZE:A	PS
원투	PS
송호범	PS
오창훈	PS
전세홍	PS
1970년대	DT
라나에로스포	PS
쳇베이커	PS
아트페퍼	PS
선진지주	OG
둔촌동	LC
아바타	PS
지나ㄴ1월하순부터	DT
제주경찰청	OG
부산동래경찰서	LC
진보정당	OG
김완주	PS
김무성	PS
마망갸또	OG
크리스마스	DT
동해항	LC
휴스턴로케츠	OG
2007년06월24일	DT
IBM	OG
HP	OG
오라클	OG
류승범	PS
삼성카드	OG
현성철	PS
자동화사업부	OG
조문기	PS
2년여	DT
KTH	OG
공공구매위반신고센터	OG
인추협	OG
이윤구	PS
한국광해관리공단	OG
영훈학교	OG
김하주	PS
나지완	PS
산티아고	LC
갈리아니	PS
파울로	PS
영광군	LC
위도	LC
칠산도	LC
경기만	LC
연평도	LC
현대·기아차	OG
1993년	DT
95년	DT
전수천	PS
1995	DT
이불	PS
1999	DT
김종규	PS
문화유산국민신탁	OG
여주도시개발	OG
지난달29일	DT
조미령	PS
신연희	PS
이달17일부터다음달13일까지	DT
4월5일	DT
스테이시루이스	PS
일제강점기	DT
서권기	PS
오는구정연휴	DT
재닛옐런	PS
Fed	OG
국회예산결산위원회	OG
지코	PS
Chad	PS
이정수	PS
매리언	PS
계산동	LC
경인여대	OG
연정훈	PS
지티아이	OG
충청지역	LC
선양주	OG
청양	LC
연말	DT
제니트	OG
한림대	OG
이영선	PS
1일자	DT
박준식	PS
사회학과	OG
마혜리	PS
청진동	LC
김명제	PS
정근우	PS
박재상	PS
님	LC
디뉴	LC
A조	OG
한광옥	PS
김성순	PS
신계륜	PS
김희선	PS
민병두	PS
11일이	DT
이번62	DT
7월28일	DT
오후5시부터	TI
이트레이드	OG
㈜에스티씨라이프	OG
삼성화재V10	OG
ym양성숙	OG
샌프란시스코	LC
경상남북도	LC
최영우	PS
전용현	PS
진광	OG
김대은	PS
한토성	PS
화순실	OG
원신연	PS
윤슬아	PS
오마르	PS
9월14일부터19일까지	DT
6일간	DT
안성강변공원	LC
안현정	PS
오후5시20분	TI
반포동	LC
가톨릭대	OG
서울성모병원	LC
지나ㄴ설	DT
차	PS
현대PwC드림투게더기업인수목적(주)	OG
게스언더웨어	OG
석시영	PS
탕웨이	PS
친일정부	OG
최상미	PS
윤상우	PS
야음초등	OG
권해효	PS
칼윤	PS
황동혁	PS
노스캐롤라이나대	OG
NYX)	OG
2011년4월28일(목)	DT
2011년도1분기	DT
KBS1	OG
쿠바산	LC
켄드리모랄레스	PS
삼성화재블루팡스	OG
크루즈	PS
KCM	PS
소찬휘	PS
데프콘	PS
범계역	LC
06시	TI
35분	TI
사당역	LC
서초구민회관	LC
주차장	LC
복정역	LC
호베르투데아시스	PS
밀라노	LC
아드리아노	PS
임준혁	PS
일제역사관	OG
플립선더스	PS
조앤잭슨	PS
4분03초52	TI
아라키	PS
김민재	PS
화하은행	OG
앨호퍼드	PS
새벽2시까지12~30분	TI
강정이기가막혀	OG
동작구	LC
신선설렁탕	OG
금천구	LC
호남식품	OG
2002년4분기이후	DT
7년여만	DT
피아자	PS
(주)구성산업개발	OG
게임	OG
드래곤플라이	OG
JCE	OG
오릭스	OG
가온누리장애인예술단	OG
라온제나밴드	OG
극단청강	OG
31일까지	DT
지나ㄴ1981년	DT
안드레아지거	PS
26년	DT
구대성	PS
엘문도데포르티보	OG
뉴욕주	LC
피츠퍼드	LC
로커스트힐골프장	OG
하ㄴ시즌	DT
조직위	OG
오는11일	DT
노회찬	PS
시청	OG
웨스브라운	PS
KOREA	LC
SEK	OG
광복절	DT
8.15	DT
국제육상경기연맹	OG
IAAF	OG
비즐리	PS
호아킴노아	PS
타이러스토마스	PS
위덕대학교	OG
전반35분	TI
권하늘	PS
후반21분	TI
곽지혜	PS
후반24분	TI
권수진	PS
스콧	PS
1월17일	DT
남극점	LC
마르카지	OG
미야토비치	PS
표도르	PS
브이큐브홀딩스	OG
에밀리아넨코표도르	PS
인천대	OG
신수천	PS
배준덕	PS
89년	DT
93년	DT
홍길동이	PS
다석	PS
함석헌	PS
다음다음해	DT
만주	LC
할빈	LC
하얼삔	LC
이토히로부미	PS
안중근	PS
용훈	PS
라캉	PS
케플러	PS
사계절	DT
만수산	LC
천년만년	DT
1월5일부터	DT
3월1일부터	DT
부차	PS
월나라	LC
4월10일	DT
코페르니쿠스	PS
아리스토텔레스	PS
국제연합	OG
UN	OG
서유럽	LC
유고	LC
발칸	LC
아하스페르츠	PS
순임이	PS
태봉이	PS
동철이	PS
황씨	PS
맨해튼	LC
민이	PS
세호	PS
釋尊	PS
김성수	PS
방천	LC
레비스트로스	PS
한국병	LC
민자당병	OG
민자당	OG
32개월	DT
전성재	PS
김선정	PS
지난달31일	DT
조동팔	PS
새롬이	PS
비슈타시파왕	PS
두환	PS
18세기후반	DT
이덕무	PS
민노총	OG
이천	LC
중세	DT
군	OG
박기자	PS
선희	PS
2개월전부터	DT
59년과62년사이	DT
데카르트	PS
우주	LC
교회당국	OG
치하서	LC
쿠웨이트	LC
제임스베이커	PS
승주	PS
한국판	LC
퇴계	PS
한낮	TI
아피아가도	LC
검여	PS
여초	PS
불교	OG
현임왕	PS
두환이	PS
일제	OG
쿠데타이후	DT
옐친	PS
국제통화기금	OG
IMF	OG
세계은행	OG
IBRD	OG
기동욱	PS
갈릴레오	PS
95년까지	DT
조국	PS
정토회	OG
다카사키	PS
65년	DT
한일	LC
지난달초	DT
후기	DT
포항제철소	OG
광양제철소	OG
권근	PS
강경대	PS
정원식	PS
발라	PS
샤론스톤	PS
호퍼	PS
케빈스페이시	PS
베이컨	PS
올6월말	DT
세시간	TI
머독	PS
안나	PS
발레르카	PS
러시아측	LC
영재	PS
밤마을	LC
60여년	DT
新民黨	OG
中國	LC
그리이스	LC
포항제철	OG
리즈테일러도	PS
김영삼정부	OG
30주년	DT
김태성	PS
한시간	TI
선수단	OG
1898년	DT
조차조약	OG
1842년	DT
1백50년	DT
97년	DT
미영	PS
이전	PS
조운	PS
흥부	PS
플라톤	PS
티코	PS
과학아카데미	OG
공륜	OG
4일부터	DT
탁선생	PS
스키부대	OG
해군부대	OG
서울지방	LC
페로	PS
5년째	DT
부산지구	LC
가야3동	LC
문화관광부	OG
김씨	PS
10년째	DT
이현태	PS
리플리	PS
12~13일	DT
미샤마이스키	PS
지기스발트쿠이켄	PS
안너빌스마	PS
페터비스펠베이	PS
바흐	PS
황새봉	LC
고대	DT
오정해	PS
신촌	LC
삼사일뒤	DT
14세기	DT
장기수	PS
경심이	PS
남경사	PS
민요섭	PS
박지원	PS
도서관정보화추진위원회	OG
TV아사히	OG
조일	OG
하벨	PS
현대그랜드뉴코아신세계	OG
기술개발공사	OG
김수근	PS
기흥성	PS
국립오페라단	OG
국립발레단	OG
국립합창단	OG
지나ㄴ9월	DT
상호	PS
박형사	PS
문장로	PS
아삽	PS
1900년	DT
미국여성	LC
총무청	OG
EC	OG
76년	DT
숙명여고	OG
동덕여대	OG
전남기계공고	OG
전남공고	OG
금파화학공고	OG
광주실고	OG
광주상고	OG
광주농고	OG
이브생로랑	OG
카트린느드뇌브	PS
보름	DT
가락동	LC
국왕방중기간	DT
방중이후	DT
경성제국대학	OG
90년7월	DT
휴스틴	LC
G7	OG
정상회담	OG
구미	LC
91년	DT
5시간동안	TI
9시	TI
유엔환경개발회의	OG
UNCED	OG
5월말	DT
연암	PS
태학사	OG
열림원	OG
10대가수그룹	OG
두달새	DT
김수용	PS
이장호	PS
이브	PS
방송위	OG
여당내	OG
하호마	PS
조로아스터	PS
정당	OG
아리만	PS
도철	PS
홍기	PS
정우성	PS
美協	OG
마케도니아	LC
알렉산더	PS
심수봉	PS
백이	PS
숙제	PS
국립현대미술관	OG
매년	DT
95년1월9일부터1월20일까지	DT
11일간	DT
현주누나	PS
김이사	PS
뭉치	PS
이씨	PS
남한	LC
박씨	PS
로스앤젤레스타임스지	OG
통일국민당	OG
고르바초프	PS
여야정치인	OG
서울올림픽	LC
국민당	OG
정주영	PS
1611년	DT
1615년	DT
카톨릭교회당국	OG
세마이어스	LC
산타페이	LC
부처님	PS
노아	PS
두어시간	TI
페르샤사산조	PS
아탁셀세스	PS
아베스타	PS
광무	PS
이준	PS
해삼위	LC
블라디보스톡	LC
이상설	PS
모스크바	LC
이위종	PS
간밤	TI
OECD그룹	OG
선녀	PS
옥녀	PS
미녀	PS
이집트인	LC
청계천	LC
훈이	PS
鄭薰姬	PS
피카소	PS
에릭사티	PS
막스야콥	PS
모딜리아니	PS
뻬뜨루최	PS
삼월이	PS
盧泰愚	PS
소련	LC
볼쇼이발레단	OG
입법회의	OG
김형사	PS
아담	PS
합천	LC
김정기	PS
2014년	DT
2022년	DT
키부츠	OG
목요일	DT
외무부	OG
보안부	OG
왕십리	LC
국가공인기관	OG
한우육품질인정기관	OG
이집트	LC
싱가포르인	LC
철현이	PS
1942년	DT
김교신	PS
57일동안	DT
정오	TI
메르세크네트	PS
오시리스	PS
이시스	PS
Isis	PS
문화부쪽	OG
지난달중순	DT
김명곤	PS
1∼1년반	DT
서방	LC
8월8일	DT
한고은	PS
우노필름	OG
李齊賢	PS
李穡	PS
鄭夢周	PS
권씨	PS
조선일보	OG
정삼용	PS
메르센느	PS
왕립학회	OG
17세기말	DT
1919년	DT
일제하	OG
최병도	PS
괴테	PS
두달치	DT
오늘날	DT
조국이	PS
표군	PS
㈜에이펙스씨큐리티	OG
김재건대표	PS
팔년	DT
경심	PS
별	LC
김대중	PS
카톨릭재단	OG
6년	DT
일년	DT
고티	PS
47년	DT
미현이	PS
영애	PS
50년전	DT
1945년1월	DT
후크	PS
한국여권	LC
북극	LC
동양인	LC
3천년	DT
김일병	PS
지나ㄴ74년부터	DT
93년말	DT
기독교	OG
새벽3,4시까지	DT
김장관	PS
구랍10일	DT
관훈클럽	OG
삼년	DT
지나ㄴ10년동안	DT
뉴튼	PS
여야	OG
교육부	OG
지나ㄴ70년	DT
로드	PS
크래프	PS
사미르	PS
뉴욕테러단	OG
작년9월	DT
아키히토	PS
동남아	LC
30여년동안	DT
리처드윌리엄	PS
조니크리스티나	PS
서양이름	LC
기득이	PS
문교부	OG
마흔아홉날	DT
윤영규	PS
워싱턴포스트지	OG
德治	PS
禮治	PS
화숙이	PS
춘복이	PS
김택성	PS
한승원	PS
지야몽	PS
미국측	LC
방한	LC
동북아	LC
5천년	DT
BC600년	DT
BC660년	DT
초반	TI
20∼50분	TI
라마다올림피아호텔	OG
하얏트호텔	OG
하루종일	DT
濟州도	LC
17세기초	DT
조선후기	DT
36년간	DT
대명측	OG
설악	LC
대명	OG
73년	DT
강성구	PS
5공화국	OG
공직자윤리위원회	OG
EMI	OG
양정고보	OG
서대문형무소	OG
일본군내	OG
항일	LC
남산골	LC
한옥마을	LC
입춘	DT
태양	LC
싱가포르	LC
87년	DT
조선일보사	OG
임시정부	OG
1950	DT
동아일보사	OG
하시모토(교본)총리	PS
정부발표	OG
6월17일	DT
북녘땅	LC
작년여름	DT
압록강	LC
길림성	LC
장백현	LC
하루빨리	DT
청주공단	LC
영태전자	OG
지나ㄴ12월	DT
상구	PS
덕수상고	OG
육성회	OG
흥사단	OG
YMCA	OG
며칠전	DT
작년초	DT
교개위	OG
3년째	DT
존워커	PS
서울중앙병원	OG
황충진	PS
Hooykaas	PS
사쿠라우치요시오	PS
앵내의웅	PS
3주일	DT
피타고라스	PS
보후마나	PS
1월1일	DT
신여망당	OG
야당	OG
이양호	PS
에게해	LC
천년쯤전	DT
우기	DT
雨期	DT
17세기	DT
합창부원	OG
11년	DT
드골	PS
지중해	LC
박노인	PS
불타	PS
9년전	DT
르미렐	LC
16세기	DT
한학기	DT
9학기째	DT
죽당	PS
닐슨	OG
원호청	OG
정구	PS
1966년	DT
한국민속관	OG
1973년	DT
1975년	DT
국립민속박물관	OG
평화회담	OG
지난해10월30일	DT
마드리드회의	OG
구소련	LC
팔레스타인	LC
레바논	LC
콜베르	PS
프랑스내	LC
야훼	PS
김부식	PS
김문열	PS
金文烈	PS
파스칼	PS
보일	PS
과학혁명기	DT
재경원	OG
용평리조트	OG
堯	PS
조광조	PS
호이겐스	PS
구보씨	PS
현재	DT
1948년4월3일	DT
9월중순	DT
김성태	PS
성공회	OG
강씨	PS
기독교신앙	OG
서양문화	LC
연천	LC
미륵	PS
라이프니츠	PS
1주년	DT
총무처	OG
홍원영사무관	PS
일제잔재	OG
크리스카터	PS
지나ㄴ6월17일	DT
몇시간	TI
84년	DT
로스엔젤레스	LC
몬트리올	LC
72년	DT
서독	LC
동독	LC
관우	PS
장비	PS
저팔계	PS
사오정	PS
KBS영상사업단	OG
17세기전반	DT
린쎄이	OG
치멘토아카데미	OG
한밤	TI
교육부장관	OG
한미	LC
알베르	PS
第6공화국	OG
부시	PS
차림	OG
욥	PS
요나	PS
니느웨	LC
지방교육청	OG
나수정씨	PS
정님	PS
세바르드나제	PS
양동사거리	LC
1610년경	DT
바알	PS
OECD	OG
정부측	OG
두레마을	OG
머튼	PS
청교도	OG
하룻밤	DT
줄리아로버츠	PS
수잔서랜던	PS
율곡	PS
1백여년	DT
18세기	DT
오스카와일드	PS
19세기말	DT
춘양	LC
중앙문화재	OG
이창복	PS
서울대	OG
이원렬	PS
나무병원	OG
강전유	PS
유재성	PS
원현임	PS
1944년	DT
1945년	DT
조선초	DT
5공화국비리조사특위	OG
대청호수	LC
폐경기	DT
메디안	LC
카이로스	PS
1994년	DT
공군	OG
브루크너	PS
1908년	DT
이왕가박물관	OG
국립중앙박물관	OG
구석기시대	DT
중앙아시아	LC
항일투쟁	LC
8·15로환국후	DT
이승만	PS
엠마누엘웅가로	PS
최영림	PS
박수근	PS
올부터88년까지	DT
점심때	TI
최고10년	DT
최저2년	DT
남미대륙	LC
김꽃지	PS
성수	PS
산타	PS
르네상스	DT
북한정책	LC
건국초기	DT
6·25전쟁때	DT
중남미	LC
조태근	PS
80년대초	DT
80년대후반	DT
동대문시장	LC
성룡	PS
추석연휴	DT
경제정의실천시민연합	OG
오숙희연구원	PS
감비노가	OG
그라바노	PS
상태	PS
프톨레마이오스	PS
미화원협의회	OG
김경종	PS
미야자와	PS
한석규	PS
심은하	PS
성북구청	OG
야당측	OG
盧	PS
지나ㄴ여름	DT
석윤이	PS
간첩남파	LC
국진이	PS
깡통	PS
民正黨	OG
수창이	PS
이어령	PS
김윤식	PS
권영민	PS
국문과	OG
김채원	PS
윤후명씨	PS
김용택씨	PS
수친다크라프라윤	PS
오르마즈드	PS
공안당국	OG
찰턴헤스턴	PS
칠팔년전	DT
카스트로	PS
노사관계	OG
노개위	OG
조인	PS
조조	PS
1646년	DT
크롬웰(Cromwell)	PS
옥스포드대학	OG
옥스포드	OG
고려말	DT
민주노총	OG
노사관계개혁위원회	OG
김간호사	PS
이완용	PS
일본인	LC
민자	OG
민주	OG
국민당대표	OG
유엔안전보장이사회	OG
발해	LC
이강산씨	PS
쪽제비	PS
오르테스강	LC
파라오람세스2세	PS
전날밤	DT
최영사	PS
북한관계	LC
세계무역기구	OG
1913년	DT
매해	DT
유럽여행	LC
100일동안	DT
여당	OG
延世大	OG
64년	DT
시카고대학	OG
李	PS
예일대학	OG
중공	OG
새벽두시	TI
40년	DT
미디안	LC
서교동	LC
(주)기흥성	OG
교육개혁위원회	OG
복장포국교	OG
최씨	PS
이주임	PS
집권여당	OG
자민당	OG
지나ㄴ8월	DT
원혁이	PS
청량리	LC
텔레토비	PS
이종은	PS
이한탁	PS
지역교육청	OG
북송	LC
고려인종기전후(11∼12세기)	DT
해병대	OG
석원이	PS
3월말	DT
장학실	OG
빌클린턴	PS
클린턴	PS
요한	PS
21일까지	DT
북한무장공비남파사건후	DT
피나바우슈	PS
부퍼탈탄츠테아터	PS
4월3~6일	DT
자우양퀴	PS
블라디보스토크	LC
로버트김	PS
미해군	OG
헌지커	PS
북한간첩	LC
미간	LC
19세기	DT
일본군	OG
45년3월	DT
태호	PS
조민환씨	PS
1백년동안	DT
30년	DT
박경리	PS
가야바	LC
안나스도	PS
유다	PS
홍제동	LC
46년전	DT
왕립과학아카데미	OG
1시간반이상	DT
6일부터10일까지	DT
강택민	PS
휴전선	LC
원식	PS
막녀	PS
장두환	PS
손봉숙	PS
거성	PS
태성	PS
대성	PS
밤늦	TI
심산씨	PS
12월16일	DT
신낙균	PS
한국음악학회	OG
한국음악평론가협회	OG
국립극장산하단체	OG
1581년	DT
엘리자베스1세	PS
밀튼레이놀즈	PS
동하	PS
정규군	OG
남침	LC
두레교회	OG
두레선교회	OG
두레유통	OG
두레연구원	OG
두레자연고	OG
용훈이	PS
나무관세음보살님	PS
羅雄培	PS
韓國	LC
美國	LC
하루속히	DT
이중섭	PS
나뽈레옹	PS
아이엠에프	OG
1664년	DT
테베노집단	OG
대한양계협회	OG
남두희기획실장	PS
융	PS
지나ㄴ연말	DT
이진경	PS
갑자일	DT
甲子日	DT
밤중	TI
자시	DT
내달18일부터내년2월20일까지	DT
서울역	LC
기노시타	PS
原始佛敎	OG
大乘佛敎	OG
아후라마즈다	PS
앙그라마이뉴	PS
요켈슨	PS
CSIS	OG
美의회	OG
프라하	LC
소련군	OG
74년	DT
김갑배	PS
박창덕	PS
체신부	OG
1~2년	DT
후세인	PS
금성사	OG
현대자동차	OG
대우자동차	OG
대우전자	OG
매일영어사	OG
귀뚜라미보일러	OG
군부	OG
우프라테스강변	LC
작년부터	DT
금년봄	DT
송도	LC
전략기동사령부	OG
통합참모본부	OG
육해공	OG
3군	OG
관세음보살님	PS
이십일전	DT
軍	OG
이틀만	DT
경성제대	OG
심	PS
김부일회장	PS
하아비	PS
한국여성노동자회협의회	OG
왕인순	PS
89년12월	DT
르네상스기	DT
사년전	DT
공비사건이후	DT
한국성폭력상담소	OG
종로5가	LC
기독교연합회관	OG
14일부터	DT
패트릭스웨이지	PS
캐슬린	PS
그날밤	TI
50년대	DT
남대문시장	LC
전준수	PS
워싱턴회담	OG
팔레스타인자치정부	OG
이스라엘군	OG
류가미	PS
김운하	PS
김설	PS
박청호씨	PS
90년대	DT
잘츠부르크	LC
바이로이트	LC
은행감독원	OG
6년째	DT
사흘씩	DT
번성	LC
야당간	OG
12년전	DT
삼년동안	DT
한국문화재보호재단	OG
김유감씨	PS
윤향순	PS
십년	DT
최진희	PS
8월중순	DT
프로코시	PS
고다르	PS
홍씨	PS
해마다	DT
4∼5월	DT
지나ㄴ가을	DT
북한사회	LC
지나ㄴ83년1월	DT
표	PS
센카쿠열도	LC
SOFA	OG
올1월까지	DT
白正	PS
충선왕	PS
元都	LC
權溥	PS
주희	PS
1세기이후	DT
한국선수단	OG
한국체육	LC
진해크먼	PS
한사군	LC
오상민	PS
마장동	LC
덕일이	PS
용두동	LC
구로사와	PS
시민단체	OG
소비자단체	OG
두산그룹	OG
최저임금심의위원회	OG
지나ㄴ87년	DT
佛敎	OG
중앙대	OG
이정현	PS
4분이내	TI
정제두	PS
설립위원회	OG
고병규씨	PS
1000년	DT
보우마나와바이슈타	PS
헬리오폴리스	LC
통산부	OG
1∼9월중	DT
9월중	DT
10년만	DT
10년쯤전까지	DT
1년1개월전	DT
나폴레옹	PS
현근이	PS
유엔안보리	OG
고분군	LC
AD4세기	DT
백제	LC
안씨	PS
작년6월	DT
기득	PS
올림피아호텔	OG
한승환	PS
중국중심	LC
조선조	DT
98년	DT
5년뒤	DT
만주땅	LC
산동성	LC
단군	PS
백여년전	DT
폴고갱	PS
빼빼	PS
피론	PS
16세기말	DT
1620년경	DT
1968년5월	DT
1981년	DT
左派	OG
냉전시대	DT
유럽자유무역연합	OG
EFTA	OG
덴마크등	LC
60∼70년대	DT
지난해2월부터	DT
오크스	PS
2차대전때	DT
우스타샤	OG
여당의원	OG
40일째	DT
밤새껏	TI
김형구	PS
한총련	OG
친북	LC
부흥여인숙	OG
20여년	DT
은신	PS
신라	LC
국민회의측	OG
UGI	OG
권병호씨	PS
97∼2000년까지	DT
넵티스	PS
리슈코프	PS
35년간	DT
45년간	DT
뉴튼식	PS
특조위	OG
고대말에서부터	DT
지나ㄴ75년	DT
전용호본부장	PS
8월초	DT
해태제과	OG
빙그레	OG
롯데삼강	OG
팜스프링스	LC
루이지애나	LC
샌타모니카	LC
지나ㄴ84년	DT
대한사격연맹	OG
대한석궁연맹	OG
시드니폴락	PS
17년전	DT
라이자미넬리	PS
주디갤런드	PS
디오니서스	PS
중국땅	LC
지나ㄴ30여년동안	DT
전씨	PS
월수입	DT
韓	LC
환갑일	DT
순이	PS
학우	PS
사춘기	DT
AFI	OG
김형구씨	PS
신씨네	OG
이윤기씨	PS
루퍼트머독	PS
유럽사회	LC
셔먼	PS
東아시아	LC
南北	LC
한국언론	OG
민	PS
여덟시간	TI
오후5시부터8시30분까지	DT
기상청예보관리과	OG
예년	DT
10월초순	DT
럭키	OG
한국화장품	OG
한국총영사관	OG
최덕근	PS
김명호씨	PS
사흘후	DT
수천년	DT
돌이	PS
올덴버그	PS
전유럽	LC
대우측	OG
박지원씨	PS
송병준씨	PS
송창의씨	PS
신민당사	OG
남영동	LC
YH무역	OG
중동지역	LC
CIA	OG
배창호	PS
4년동안	DT
독일지배	LC
학도호국단	OG
7~8일	DT
미국영화협회	OG
MPAA	OG
제프리하디	PS
아시아태평양	LC
산업자원부	OG
재작년가을	DT
어린이대공원	LC
압구정동	LC
여	OG
야	OG
인종	PS
인조	PS
월간	DT
필	OG
15년	DT
용인자연농원	LC
호암미술관	OG
선사시대	DT
5년전부터	DT
서초동	LC
심만순	PS
문	PS
唐末	DT
宋	LC
明	LC
이북	LC
일본잡지	LC
10년전	DT
종수	PS
1600년에서1603년까지	DT
Pudua대학	OG
베살리우스	PS
콜롬보	PS
갈레노스	PS
월평균	DT
光武帝	PS
子陵	PS
호루스	PS
매주토요일	DT
오후4시부터	TI
아랍	LC
성산왕산	LC
왕가위	PS
12월31일	DT
체코내	LC
유엔군사령부	OG
UNC	OG
북한간	LC
헤즈비이슬라미	OG
우즈베크민병대	OG
한국의료기술진	OG
존슨	PS
한국의료	LC
군사분계선	LC
서해5도	LC
합중국	LC
충무로	LC
누트	PS
아톤	PS
아멘라	PS
이시스교	OG
이강산	PS
정영민씨	PS
마띨데우르떼아	PS
콜베르로	PS
조직형	PS
박생광	PS
김은호	PS
45년	DT
鄭逑	PS
金長生	PS
양동	LC
창신동	LC
아홉시	TI
대만사회	LC
서양	LC
三星전자	OG
유럽공동체	OG
日本	LC
명구	PS
임양임	PS
영천	LC
이재화	PS
남쪽	LC
20여일	DT
걸스카우트	OG
한국지역사회교육후원회	OG
대한YWCA	OG
문민정부초기	DT
혼마찌국민학교	OG
한의과대학	OG
베르사체	PS
이브닝	TI
하이텔	OG
극동	OG
노조측	OG
린쎄이아카데미	OG
체지공	PS
레오폴드공	PS
메르센트	PS
수친다	PS
카셋	PS
이사라	PS
차이나롱	PS
재민	PS
칼더	PS
북반구	LC
교회	OG
그해	DT
오스만	LC
터키제국	OG
3백년	DT
예루살렘	LC
텔아비브	LC
연극배우협회	OG
북한측	LC
노조운동	OG
지나ㄴ10여년동안	DT
여름상품	DT
노사	OG
摹瑟浦	LC
보름전	DT
시브가툴라모자디디	PS
만화모세	PS
두꺼비	PS
임형사	PS
지나ㄴ70년대	DT
레블론화장품	OG
로렌허튼	PS
반정부	OG
친북한	LC
인민회의	OG
천석이	PS
임계	LC
나일	LC
백두	LC
한라	LC
중소기업협동조합중앙회	OG
기획예산처	OG
행정자치부	OG
정보통신부	OG
오부치	PS
다케시타	PS
나카소네야스히로	PS
중증근강홍	PS
97년말	DT
월스트리트	LC
모자디디	PS
라바니	PS
카불시	LC
라타	PS
羅陀	PS
메소포타미아	LC
서총련	OG
허씨	PS
불교환경교육원	OG
생태학교	OG
생명운동아카데미	OG
문경정토수련원	OG
안보리의장	OG
이무하	PS
한재용	PS
민호	PS
첫날밤	DT
서울여고	OG
도봉구	LC
번동	LC
이강생	PS
양귀매	PS
지나ㄴ7,80년대	DT
새벽길	TI
그해연말	DT
한국소비자보호원	OG
이근철	PS
씨네21	OG
정두홍씨	PS
파리국립음악원	OG
미얀마	LC
아웅산묘소	LC
83년	DT
지나ㄴ7∼8월	DT
지나ㄴ80년대	DT
모니오빠	PS
석가모니	PS
88년이후	DT
바이츠제커	PS
콜	PS
킨켈	PS
성균관대	OG
김성준	PS
아남전자	OG
바벳슈로더	PS
브리지트폰다	PS
제니퍼제이슨리	PS
크리스패턴	PS
송가스	PS
반다나시바	PS
한재각	PS
권영근	PS
이양	PS
수년간	DT
내년상반기	DT
1월31일	DT
몇년후	DT
20년대	DT
문민시대	DT
38이북땅	LC
순이역	PS
다케시타파	PS
맬릭	PS
바트	PS
의정지기단	OG
레오쎄이어	PS
TK	LC
메도우사	PS
입법부	OG
행정부간	OG
문화재관리국	OG
제일기획	OG
김낙회	PS
연변대	OG
18,19세기	DT
24년	DT
존폴슨	PS
올여름	DT
도고파라다이스호텔	OG
김종화씨	PS
20년	DT
문예진흥원	OG
연극협회	OG
대구인구	LC
챨스2세	PS
84년부터	DT
존고티	PS
대보름날	DT
민선생	PS
라미	PS
몰리	PS
데이비드	PS
서정화	PS
박찬종	PS
유기수	PS
고려인종때	DT
82년	DT
정몽주	PS
김장생	PS
정경세	PS
박세채	PS
소보원	OG
최충대	PS
한국대표선수단	OG
1984년	DT
출전선수단	OG
연천역	LC
서울행	LC
18개월동안	DT
6시간	TI
밤낮	TI
與野	OG
1948년	DT
대한민국임시정부	OG
대한민국정부	OG
1936년	DT
무장공비침투사건이후	DT
하와이	LC
괌	LC
14일까지	DT
럿셀	PS
만재	PS
성재	PS
북한실정	LC
달나라	LC
오나라	LC
회계산	LC
會稽山	LC
구천	PS
句踐	PS
하룻밤새	DT
구청직원	OG
한나절	DT
중국식	LC
60년대	DT
이병주	PS
이봉구	PS
봄맞이국	DT
로보	PS
푸	PS
포	PS
몽모르	OG
이미숙	PS
자치정부	OG
7월말	DT
차왈리트	PS
한국소방검정공사	OG
開城	LC
덕물산	LC
최영	PS
매월	DT
총선공정성시비특별조사위원회	OG
고동	PS
하스불라토프	PS
가이다르	PS
지나ㄴ15일	DT
김일성	PS
차승재씨	PS
유비	PS
한국인	LC
임실	LC
마암분교	OG
종군위안부	OG
산악지방	LC
근현대	DT
나일강	LC
전대협	OG
고려초	DT
崔承老	PS
이제현	PS
이색	PS
운총	PS
카네프스키	PS
아난	PS
티베리우스	PS
후안	PS
안토니오	PS
사마란치	PS
내한	LC
지구촌	LC
보도본부	OG
MPC	OG
지나ㄴ주부터	DT
동사무소	OG
개화기	DT
70년이전	DT
내년4월	DT
김춘미	PS
체르노미르딘	PS
40년간	DT
포철	OG
두해	DT
일신창투	OG
지나ㄴ25년	DT
오스트리아	LC
7백년	DT
PKO	OG
자위대	OG
건전비디오연구를위하ㄴ모임	OG
건비연	OG
국군의날	DT
한글날	DT
공휴일	DT
정부당국	OG
7시간	TI
전희철	PS
디오게네스	PS
EU	OG
아일랜드	LC
아이슬란드	LC
밤무대	TI
탁봉호씨	PS
며칠후	DT
오전10시30분부터오후6시까지	TI
정도전	PS
바그다드	LC
라마디	LC
지나ㄴ73년	DT
도교	OG
63년부터	DT
크렘린	LC
대전대	OG
1차대전이끝나ㄴ후	DT
합스부르그제국	OG
드림써치	OG
황정욱	PS
즈윅	PS
대제관가야바	PS
바리사이파	LC
김죽화	PS
무순시	LC
요녕성	LC
9개월	DT
곰	PS
野	OG
티쉬트랴	PS
시리우스	PS
프라바쉬등	PS
아수라	PS
유엔평화유지활동	OG
PKO)	OG
캄보디아	LC
4자회담	OG
정전협정	OG
휴전협정	OG
한국아이비엠관	OG
한국후지쓰관	OG
롯데환타지월드	OG
밤새	TI
순천향병원	OG
이동화	PS
말기	DT
다윗	PS
골리앗	PS
사무엘	PS
스펜타	PS
소아시아	LC
북(北)시리아	LC
신성우	PS
학교	OG
한말	DT
李恒老	PS
奇正鎭	PS
李震相	PS
金平默	PS
柳重敎	PS
柳麟錫	PS
50,60년대	DT
홍콩가요	LC
그레이스창	PS
명이	PS
가나안	LC
롯	PS
이간	PS
한원진	PS
소현세자	PS
청나라	LC
9년동안	DT
로동신문	OG
김진태씨	PS
재작년	DT
김정회	PS
학백촌	PS
국립도서관	LC
영훈중	OG
성암여상	OG
대진여고	OG
명성여고	OG
홍대부속여고	OG
도시가스회사	OG
사우디	LC
잠수함침투사건이후	DT
북한응징	LC
문희웅	PS
페레	PS
야스쿠니(정국)신사	LC
안익태	PS
김동진	PS
김순남	PS
이건우	PS
연대	OG
에마누엘부인	PS
봄내음	DT
통일한국	LC
엔트로피	PS
셀류키아	LC
사흘전	DT
1시간이상	TI
中共	LC
武漢대학	OG
미국적	LC
李鴻永	PS
예일대	OG
1699년	DT
지나ㄴ48년	DT
사적공원	LC
율브린너	PS
6·29	DT
프리츠랑	PS
호머	PS
50년대말	DT
40년동안	DT
지나ㄴ10년간	DT
기흥성이	PS
세종대왕	PS
충무공	PS
안보리	OG
대미단독평화협정	OG
힐러리클린턴	PS
김도연	PS
민주통일민중운동연합	OG
민주언론운동협의회	OG
언협	OG
이석원	PS
강남병원	OG
김유신	PS
청천강	LC
수나라	LC
을지문덕	PS
이태조	PS
세종	PS
왜국	LC
남한산성	LC
십년전	DT
경술년	DT
디카프리오	PS
더	OG
유영모	PS
56억7천만년뒤	DT
군부대	OG
지나ㄴ4월초부터10월말사이	DT
두시간	DT
경희대의대	OG
허충림교수	PS
7.14~9.9	DT
3개월	DT
연천읍	LC
신구	PS
하루낮	DT
현부	LC
잠실체육관	LC
연극회생을위하ㄴ비상대책위원회	OG
정진수	PS
샤를보들레르	PS
반세기	DT
두달동안	DT
에덴버그	LC
프린세스마가렛로즈병원	OG
해방이후	DT
48년	DT
남산학교	OG
자마이카	LC
윌리엄데버록스	PS
뉴욕시	LC
윌리엄	PS
유럽단위	LC
鄭漢模	PS
문공부	OG
북한자료	LC
42년전	DT
헝가리	LC
신익희	PS
이승만쪽	PS
7월30일	DT
비대위	OG
불교배척	OG
민주파	OG
제기동	LC
민중탕제원	OG
김순자	PS
12월9일	DT
가네마루	PS
하버드	OG
서울대총학생회	OG
12년	DT
슈메이커	PS
틸렐리	PS
한미협회	LC
판문점	LC
28일부터	DT
코엔	PS
1950년대부터	DT
아침동트ㄹ무렵	DT
멀더	PS
스컬리	PS
일제때	DT
정신대	OG
백유	PS
저녁나절	TI
구로동	LC
오시리스교	OG
호루스교	OG
신자철	PS
지난달24일	DT
이라크군	OG
4시간동안	TI
1618,9년까지	DT
코라진	PS
케리	PS
입시철	DT
45년1월	DT
매일신보	OG
프로이트	PS
김굉필	PS
영국사회	LC
카톨릭신앙	OG
김동이	PS
다음다음날	DT
합려	PS
閤廬	PS
夫差	PS
신야	LC
고려병원	OG
박용우	PS
새마을운동중앙협의회	OG
열한시	TI
리처드게파트	PS
로이드벤센	PS
마리오쿠오모	PS
뉴욕주지사	LC
노성대	PS
노조쪽	OG
청소년지도육성회	OG
스승의날	DT
한달간	DT
(주)리서치앤리서치	OG
엘	PS
다곤	PS
아쉐라	PS
아나트	PS
얌	PS
모트	PS
아스타르트	PS
코샤르	PS
하시스	PS
샤피시	PS
아타르	PS
등소평	PS
지방	LC
4월9일까지	DT
앨런소칼	PS
승훈이	PS
청파동	LC
사해	LC
소돔	LC
고모라	LC
고려조	DT
유진오	PS
1944년9월	DT
아리스토텔레스식	PS
20일동안	DT
수일전	DT
15세기중엽	DT
이천설봉호텔	OG
라승미씨	PS
12월10일	DT
시민사회단체	OG
1609년	DT
동북아안정	LC
10여일	DT
하춘화	PS
송호영	PS
수안보파크호텔	OG
박영길씨	PS
2개월전	DT
유태우	PS
십년동안	DT
로마군	LC
정부예산	OG
교육부문	OG
구랍4일	DT
라자&라다레디무용단	OG
판디트바잔소포리연주단	OG
6,7일	DT
국악원	OG
인도전통	LC
신동구	PS
화요일	DT
주말마다	DT
태릉사격장	LC
全	PS
7시30분	TI
지나ㄴ5년	DT
남북대화	LC
오(吳)나라	LC
월(越)나라	LC
1660년	DT
그레샴칼리지	OG
도종환씨	PS
골고다	LC
최순우	PS
1971년	DT
沖繩	LC
경상도	LC
팔년전	DT
카인	PS
아벨	PS
박금자박사	PS
동구권	LC
동남아지역	LC
발발(18세기)이후	DT
조선조말	DT
약2세기동안	DT
수십년동안	DT
다석일지	PS
다음주중	DT
지난달24일부터	DT
쌍무협상	OG
제이티에스	OG
조인투게더소사이어티	OG
나진	LC
선봉지구	LC
太宗때	DT
개혁통신	OG
노사정위원회	OG
국가인권위원회	OG
남북한간	LC
미측	LC
濟州	LC
페리	PS
그레이스	PS
다니엘코맥	PS
고씨	PS
1963년까지	DT
약35년동안	DT
영국내	LC
해방정국기간	DT
여운형	PS
장덕수씨	PS
백범암살	PS
金宏弼	PS
南孝溫	PS
나흘째	DT
초봄	DT
1616년	DT
이년전	DT
76~83년	DT
애수	PS
돈루스	PS
한국소방안전협회	OG
김종관	PS
바리사이파사람	LC
재미	LC
평화협정	OG
조지부시	PS
미국대통령	LC
연산동	LC
제임스해리스	PS
가네마루신	PS
금환신	PS
60년대후반	DT
리우	LC
코파카바나해변	LC
이과수폭포	LC
25시간동안	TI
좌익	OG
샤	PS
3년6개월	DT
6.10~9.10	DT
베로나	LC
1세기말	DT
신성우형	PS
성우	PS
김종영	PS
기타노	PS
85년1월이후	DT
11년8개월	DT
석달	DT
93년1월이후	DT
3년8개월	DT
宋나라	LC
徽宗皇帝	PS
江蘇	LC
金山寺	LC
揚子江上	LC
黃伯禪師	PS
고척동	PS
경심아	PS
작년12월17일	DT
금성	LC
12	DT
해아	LC
박홍	PS
북한대변	LC
클로드레비스트로스	PS
우르바누스(Urbanus)8세	PS
1628년	DT
인민권력전국회의	OG
군통수	OG
김숙희	PS
교육부내	OG
9년간	DT
17세기이후	DT
중앙회	OG
제6공화국정부	OG
제5공화국정부	OG
작년9월19일	DT
몬로	LC
카운티	LC
지방법원	OG
그레터포드주	LC
수년전	DT
정찬호	PS
36,7년전	DT
11월말	DT
인천시교육감	LC
15세기	DT
헝가리왕국	OG
크로아티아	LC
고광순씨	PS
대낮	TI
에파미논다스	PS
줄리아크리스테바	PS
장보드리야르	PS
질들뢰즈	PS
펠릭스가타리	PS
폴비릴리오	PS
90일	DT
외국	LC
심교수	PS
근대	DT
우디	PS
이노우에히사시	PS
오후4시30분	TI
善竹橋	LC
쿠웨이트시	LC
지난달27일	DT
갈릴레오등	PS
심플리치오	PS
孟子	PS
시민단체연대	OG
테베노	OG
정윤미	PS
이상선	PS
여름날	DT
루돌프크시아노프스키	PS
프란시스베이컨	PS
방리동	LC
몽촌토성	LC
풍락토성	LC
암사동	LC
선사	DT
남파	LC
오후반	TI
오전동안	TI
장막	PS
성소	PS
53년7월27일	DT
92년2월	DT
여야간	OG
가톨릭	OG
2백년	DT
알랭베를리네	PS
정대석	PS
르네상스시대	DT
김선임	PS
강군	OG
빌게이츠	PS
1962년	DT
마릴린먼로	PS
1952년	DT
진콘맨	PS
종출이	PS
15,16세기	DT
체코슬로바키아	LC
경제협력개발기구	OG
1일부터	DT
3주동안	DT
길보아산	LC
요나단	PS
에루살렘	LC
스가랴	LC
예레미아	PS
교육철학회	OG
백화점협회	OG
박태우과장	PS
시드니쯤	LC
한국자동차협회	OG
북한동포	LC
경총	OG
파르티아	LC
바벨론	LC
북한군	OG
5시간	TI
군사정전위원회	OG
시아라마스트로야니	PS
마르첼로마스트로야니	PS
하나고등학교	OG
이새롬	PS
1632년	DT
조르주뒤비	PS
서기1천	DT
2천	DT
北韓	LC
레이건	PS
全斗煥	PS
이기순씨	PS
에릭스티븐	PS
제주도해안	LC
이사회	OG
조씨	PS
최경화	PS
탁봉호	PS
삼십분전	TI
10월14일	DT
리오넬조스팽	PS
중앙정보부	OG
현중	PS
대미간	LC
94년	DT
명인	PS
국왕방중전날	DT
오산학교	OG
초읍	LC
이북땅	LC
새벽종	TI
지나ㄴ8월10일	DT
피츠워터	PS
도춘방	PS
전국부녀연합회	OG
역대정부	OG
여성정치연구소	OG
팔년동안	DT
강제억	PS
10여분	TI
94년12월16일부터95년1월14일까지	DT
서울시내	LC
슬로바키아쪽	LC
리스본	LC
30년전	DT
3월1일	DT
인수	PS
동수	PS
희랍인	PS
불가리아	LC
우창이	PS
남진	PS
地球레코드	OG
충청도	LC
김춘씨	PS
문성근씨	PS
국립국악관현악단	OG
롱아일랜드	LC
교황청	OG
1951년	DT
웨스트사이드	LC
일일점검	DT
日本軍	OG
日帝	LC
반후세인	PS
지나ㄴ80년대말부터	DT
白凡金九	PS
古下	PS
雲山	PS
夢陽	PS
바빌로니아	LC
중앙일보사	OG
6공화국	OG
7·7	DT
북한자세	LC
文昌洙	PS
해강도자박물관	OG
송암미술관	OG
남양주군	LC
모란미술관	OG
신천지미술관	OG
오스트레일리아	LC
7.23~8.31	DT
모차르트	PS
유럽축제	LC
빈필	PS
동일여고	OG
81년도	DT
沈	PS
혜원동	LC
한국여성단체협의회	OG
지난달30일	DT
삼성그룹	OG
삼성측	OG
정씨	PS
에두아스페샤	PS
유니세프	OG
화란	LC
헤이그	LC
만국평화회의장	LC
정필준	PS
북경대	OG
플로렌스	LC
토리첼리	PS
유덕화	PS
조희연	PS
성공회대	OG
서준식	PS
인권운동사랑방	OG
엔지오	OG
60~70년대	DT
1999년12월31일	DT
자정	TI
장순영	PS
7월1일이후	DT
서울대병원	OG
백병원	OG
봅캐리	PS
베트콩	OG
11월7일	DT
일리히	PS
부처	PS
奇大升	PS
김대통령	PS
2주간	DT
6·25	DT
군납업	OG
법전(法專)	OG
고상(高商)	OG
관립전문학교	OG
1944년부터	DT
경성경제전문학교	OG
김언호	PS
원철희	PS
방일	LC
작년8월	DT
가이후도시키	PS
해부준수	PS
방중	LC
장폴고티에	PS
파코라반	PS
6월13일	DT
지난해10월	DT
조수미씨	PS
3월28일	DT
홍혜경	PS
제니퍼라모어	PS
프란시스코아라이자	PS
안드레아보첼리	PS
올라프베어	PS
바바라보니	PS
안드레아스숄	PS
현대고	OG
민경찬	PS
음악원	OG
이영미씨	PS
20여일간	DT
오후2	TI
6시	TI
6시30분	TI
앤서니밍겔라	PS
클레망	PS
정두홍	PS
대중국	LC
삼봉	PS
기획시대	OG
환기미술관	OG
김환기	PS
지나ㄴ봄	DT
전국노래연습장협회	OG
서부지회	OG
한국조류학회	OG
원병오	PS
경희대	OG
지나ㄴ75년부터83년도까지	DT
미사리	LC
고수부지	LC
1680년대경	DT
1박2일간	DT
호돌이	PS
소방본부	OG
디아스포라	LC
1시간전부터	TI
매(每)천년마다	DT
제네바핵합의	OG
지나ㄴ10년	DT
86년서울아시아경기대회당시	DT
덕소땅	LC
새벽2시	TI
연말대선	DT
페르샤	LC
한덕수	PS
보리스옐친	PS
공휴국경일	DT
이활	PS
크닌	LC
크라이나	LC
바니아	LC
카톨릭	OG
그리스정교	OG
1천년	DT
을사보호조약	OG
OECD교육위원회	OG
정림건축	OG
새마을쇼단	OG
현북	LC
지나ㄴ72년	DT
서울대대학원	OG
이태리	LC
레닌	PS
티코브라헤	PS
5년동안	DT
케미컬은행	OG
체이스맨해튼은행	OG
미쓰비시	OG
삼릉	OG
ING	OG
베어링스	OG
오후2∼4시	TI
낮12시	TI
오후시간대	TI
3~5년	DT
한세대	DT
부천시의회	OG
66년이후	DT
어느날	DT
지나ㄴ날	DT
40시간	TI
은아	PS
예고르가이다르	PS
한국걸스카우트연맹	OG
서울시연맹장	LC
윤용자씨	PS
마치지	OG
브리짓포세이	PS
마리아당	PS
잉그리드버그만	PS
이자벨라로셀리니	PS
제인비르킨	PS
살로트갱스부르	PS
전일재씨	PS
시세라	PS
야엘	PS
예산위원회	OG
1980년대이후	DT
울진	LC
삼척공비	LC
청와대기습	LC
판문점도끼	LC
건모	PS
대영제국	LC
이란영화	LC
갱년기	DT
영식이	PS
지만	PS
어버이날	DT
56년	DT
한국건축가협회	OG
이슬이	PS
6년전	DT
종로거리	LC
여름습관	DT
미야자와기이치	PS
궁택희일	PS
朴京沃	PS
하오7시반	TI
12월24일	DT
헌재	OG
키레네사람시몬	PS
10여년	DT
상규	PS
연성소	OG
창신	LC
팔동	LC
깜씨	PS
10월1일	DT
알프스리조트	OG
27일부터내달4일까지	DT
한국기독교성직자시국기도회	OG
저녁여덟시	DT
富春山	LC
嚴子陵	PS
16일동안	DT
올림피아고원	LC
헤라신전	LC
제주공항	LC
열이틀	DT
公州	LC
ARD	OG
ZDF	OG
바이에른주	LC
독일방송	LC
저녁시간	TI
국립섬유수사연구소	OG
쿼터빤쭈	OG
106일	DT
구소련공산당	OG
지나ㄴ7월부터	DT
명보	OG
군사정전위	OG
지휘부	OG
5시	TI
갑천호수	LC
1592년	DT
Padua대학	OG
79년도	DT
30·31일	DT
국회5공화국비리특별위	OG
국방위	OG
40여분	TI
1백59일간	DT
성동고	OG
구청측	OG
자연농원레이싱팀	OG
송호진	PS
혜산군민회	OG
지나ㄴ6월10일	DT
94년8월	DT
지난날	DT
쌍마자동차	OG
니카라과	LC
12월18일	DT
국민회의	OG
신기남	PS
활동사진	OG
정우성씨	PS
학생회	OG
1680년대	DT
시마자키	PS
엔야	PS
에쵸티	PS
한국방송공사	OG
에스비에스	OG
에스엠	OG
에스이에스	OG
황해도	LC
서울풍물단	OG
1977년	DT
두팔이	PS
두칠이	PS
세팔이	PS
산토스해변	LC
송대	DT
북방외교	LC
문민정부	OG
자메이카	LC
우주구조	LC
토너리강	PS
1988년	DT
평강군	LC
회산면	LC
정미년칠월열나흘날	DT
엔터콘코리아	OG
캘리포니아월드	OG
99년	DT
17,18세기	DT
기독교도	OG
플릭	PS
한국교회	LC
늦가을	DT
단양	LC
돈키호테식	PS
백범	PS
매봉산	LC
박선영씨	PS
43년	DT
노동자문학회	OG
연립여당	OG
자히르샤	PS
국왕시대	DT
샤국왕	PS
정부수립	OG
김태식	PS
光武	PS
백제시대	DT
美예일大	OG
시에나음악학교	OG
정부차원	OG
중국인	LC
체니	PS
중국문화	LC
7월22일	DT
이춘연	PS
기씨	PS
민족음악연구회	OG
對韓	LC
2년반	DT
7년반	DT
한두달	DT
중세기	DT
천여년	DT
지나ㄴ1월26	DT
십여년전	DT
이라스토텔레스	PS
카프카	PS
20년간	DT
한탄강	LC
가락시장	OG
용산시장	OG
류가미씨	PS
근대사회	DT
이빈씨	PS
몽실	OG
2∼3년전	DT
정희	PS
권인혁	PS
우노	OG
차승재	PS
신라시대	DT
폴매카트니	PS
하타	PS
가지야마	PS
인디펜던트지	OG
서기1000년무렵	DT
기독교세계	OG
한국영화	LC
한국사람	LC
개미플릭	PS
말린피츠워터	PS
국방안보관계자회의	OG
엑스포	OG
하루입장객	DT
룩셈부르크	LC
김창기	PS
김은정씨	PS
우파	OG
사흘뒤	DT
야당지도자	OG
행정위원회	OG
구한말	DT
高宗	PS
80여년	DT
밤12시	TI
기독교문화	OG
헤롯	LC
야스쿠니	LC
대우	OG
맷데이먼	PS
퍼트리샤하이스미스	PS
톰리플리	PS
